OTU,ALancangBesar,BPari,CTidung,DKarangBeras,EPramuka,FKotok,GSepa,Rowsums
ASV213,2976,4894,7671,6566,9714,7361,7976,47158
ASV1471,3317,3532,6829,11670,7247,7389,4108,44092
ASV1466,268,1432,4754,3878,6032,4742,18633,39739
ASV853,990,5165,10163,5788,4165,5320,2713,34304
ASV586,1158,2201,3813,3292,4208,3116,4127,21915
ASV5295,266,440,14192,1761,2633,2552,70,21914
ASV2284,2273,3259,1820,3027,2471,4270,2213,19333
ASV1944,658,2671,1043,2839,4293,3627,3641,18772
ASV23,2917,1570,522,1042,2300,3297,1790,13438
ASV2242,40,923,517,6020,3084,543,1386,12513
ASV5446,615,1257,1020,1844,1749,1921,2928,11334
ASV1659,501,1333,740,1462,2022,1974,2101,10133
ASV10173,47,286,1886,1752,1116,4288,614,9989
ASV1222,543,1130,2115,1556,1752,1310,1514,9920
ASV2953,458,534,334,4154,2933,570,919,9902
ASV3846,342,1495,442,1009,1815,2354,2204,9661
ASV499,676,917,439,2017,3387,991,1175,9602
ASV3106,326,1583,642,987,1324,2759,1963,9584
ASV2273,411,953,1133,2176,2187,1096,1316,9272
ASV964,297,1138,1826,1312,1099,1846,1688,9206
ASV9404,115,460,2456,1395,1052,2740,876,9094
ASV2058,354,774,1347,1597,1788,1056,1911,8827
ASV4752,1642,623,255,352,1530,1853,2543,8798
ASV1320,14,65,6101,23,103,2259,180,8745
ASV10352,0,5098,1433,1206,789,0,35,8561
ASV2134,994,464,466,760,1668,3093,1014,8459
ASV182,103,552,857,1517,1040,3578,701,8348
ASV614,277,1064,475,1042,1649,1428,2041,7976
ASV908,591,1215,527,844,1245,2084,1469,7975
ASV761,132,2045,21,1623,1585,1774,682,7862
ASV5938,41,1260,1481,1425,333,1741,1494,7775
ASV3142,439,1299,579,708,1963,1202,1522,7712
ASV1179,956,495,2682,734,592,853,1377,7689
ASV1309,791,758,430,974,1512,1653,1550,7668
ASV3441,742,666,1255,1484,1414,888,1043,7492
ASV852,385,1680,418,1156,1182,1558,1076,7455
ASV6306,237,921,426,917,1764,1886,1163,7314
ASV117,273,348,1659,762,786,869,2257,6954
ASV2697,331,792,401,707,1816,969,1755,6771
ASV1911,234,591,1241,936,1167,1088,1442,6699
ASV1436,547,760,1072,1046,1170,1019,1034,6648
ASV2858,320,533,1148,1155,1117,1004,1214,6491
ASV6630,652,346,539,457,335,2595,1505,6429
ASV4189,215,284,1378,886,749,2356,514,6382
ASV4556,481,576,439,585,1128,1391,1752,6352
ASV1126,30,41,1271,2280,799,1853,58,6332
ASV4430,80,207,954,2458,1803,228,594,6324
ASV10909,243,967,1673,517,1069,1029,768,6266
ASV2243,260,1025,386,783,719,1673,1352,6198
ASV9892,66,79,4490,587,387,572,8,6189
ASV465,595,484,966,1005,804,1358,935,6147
ASV8775,78,132,2087,2001,744,619,448,6109
ASV7804,12,582,966,2907,867,220,535,6089
ASV464,208,1116,400,856,803,1673,1012,6068
ASV426,345,1073,432,679,959,1336,1115,5939
ASV1411,243,771,370,996,980,1136,1356,5852
ASV1263,210,107,835,501,2648,284,1250,5835
ASV3031,1876,269,54,796,484,2002,310,5791
ASV11921,336,435,171,3566,938,145,149,5740
ASV780,289,586,384,713,1268,933,1472,5645
ASV1057,336,834,219,917,1193,1014,1061,5574
ASV9195,257,607,1046,887,762,825,875,5259
ASV656,297,564,818,906,1027,654,959,5225
ASV2793,101,524,1295,556,664,873,1093,5106
ASV255,293,385,732,887,902,429,1386,5014
ASV817,17,444,690,1208,307,1119,1137,4922
ASV184,408,900,431,593,761,1074,691,4858
ASV2955,237,958,212,526,1236,542,1067,4778
ASV1927,277,298,897,779,1458,229,785,4723
ASV4812,235,742,313,813,716,984,869,4672
ASV4310,123,503,1171,618,628,675,937,4655
ASV11374,429,605,1194,343,995,438,540,4544
ASV17283,2,32,6,809,578,473,2641,4541
ASV108,156,722,793,519,880,770,682,4522
ASV597,570,611,872,526,605,639,628,4451
ASV4245,291,611,785,718,803,632,592,4432
ASV13574,128,287,1167,1928,298,323,275,4406
ASV4822,490,747,124,529,673,937,896,4396
ASV5104,284,523,216,773,646,640,1198,4280
ASV4402,362,483,213,397,536,1307,972,4270
ASV6188,200,822,453,451,547,1043,657,4173
ASV1546,2542,66,23,394,522,423,181,4151
ASV6171,232,405,481,380,872,1015,761,4146
ASV3860,211,470,285,516,663,929,1070,4144
ASV5217,243,489,122,680,771,1415,415,4135
ASV19837,530,610,501,1319,193,356,590,4099
ASV8748,0,0,0,0,4052,0,0,4052
ASV8418,88,1133,11,1072,1089,373,204,3970
ASV618,329,370,487,606,752,361,993,3898
ASV8159,332,478,253,405,1217,738,468,3891
ASV6881,265,537,244,553,676,920,671,3866
ASV8315,14,700,1043,1039,609,307,111,3823
ASV9298,1189,164,148,97,493,1328,327,3746
ASV3372,379,343,629,511,1008,453,422,3745
ASV1804,27,1101,202,643,337,900,451,3661
ASV731,158,403,231,2684,74,29,69,3648
ASV4578,295,590,273,451,729,661,627,3626
ASV3965,195,424,697,797,628,325,533,3599
ASV3438,318,233,518,603,736,271,843,3522
ASV11804,186,343,569,681,519,618,568,3484
ASV5325,136,369,822,429,382,570,729,3437
ASV9060,146,138,67,2095,843,28,24,3341
ASV1439,47,1864,143,859,77,240,94,3324
ASV20303,149,411,546,478,523,569,615,3291
ASV826,148,323,638,500,492,452,719,3272
ASV696,181,366,241,494,550,737,677,3246
ASV449,73,28,79,2800,89,88,71,3228
ASV7133,36,160,1091,261,186,528,933,3195
ASV4421,113,199,863,664,351,639,341,3170
ASV17163,9,56,2272,22,1,644,143,3147
ASV1054,67,906,439,917,244,238,325,3136
ASV6079,135,194,559,658,775,485,320,3126
ASV12084,267,324,461,515,610,469,458,3104
ASV5450,139,326,281,195,527,753,832,3053
ASV658,203,356,521,475,570,437,439,3001
ASV1212,231,276,841,417,428,439,366,2998
ASV3460,315,227,909,719,272,300,227,2969
ASV5809,59,334,500,324,542,443,724,2926
ASV858,7,537,148,884,506,544,276,2902
ASV3546,117,211,351,912,580,154,572,2897
ASV3634,192,809,197,105,884,698,12,2897
ASV4094,741,150,112,497,253,488,625,2866
ASV969,85,358,161,243,334,942,722,2845
ASV8320,31,520,93,600,479,146,914,2783
ASV3119,71,201,105,169,463,335,1434,2778
ASV19190,0,1974,1,0,799,0,0,2774
ASV4356,359,336,473,421,454,370,338,2751
ASV16583,38,670,824,89,40,1016,34,2711
ASV5445,73,376,196,356,416,652,633,2702
ASV945,584,95,11,689,121,621,555,2676
ASV3118,104,522,151,391,297,706,482,2653
ASV189,82,82,996,282,213,543,451,2649
ASV3583,158,0,2443,0,0,0,0,2601
ASV647,129,410,309,257,244,891,351,2591
ASV3970,206,376,106,159,298,994,448,2587
ASV4280,175,225,522,516,520,305,262,2525
ASV1338,56,378,662,315,395,443,268,2517
ASV1872,110,394,466,276,349,464,435,2494
ASV2406,62,237,190,78,66,1701,150,2484
ASV1099,138,277,242,412,622,146,586,2423
ASV7875,54,251,395,280,570,353,468,2371
ASV4736,319,197,272,542,517,115,401,2363
ASV13599,1,112,843,234,108,1023,41,2362
ASV2008,94,164,526,319,546,329,364,2342
ASV6618,204,406,384,312,698,111,210,2325
ASV2526,6,1128,499,480,199,0,0,2312
ASV19380,25,13,2,1450,362,260,166,2278
ASV2981,164,670,42,355,498,463,35,2227
ASV1706,264,246,331,448,462,186,280,2217
ASV8578,249,237,121,197,399,400,613,2216
ASV735,137,356,706,168,291,299,258,2215
ASV4597,0,368,1683,27,100,14,15,2207
ASV7665,112,263,436,442,400,236,312,2201
ASV3346,50,274,148,244,298,557,626,2197
ASV6232,22,713,15,640,418,313,76,2197
ASV2940,159,154,669,354,421,184,250,2191
ASV2661,173,485,285,335,301,379,213,2171
ASV3104,23,516,1128,75,87,207,131,2167
ASV7757,89,204,256,421,363,265,555,2153
ASV1695,228,217,459,342,309,382,204,2141
ASV10887,80,317,198,184,400,548,406,2133
ASV6528,136,229,106,349,331,314,631,2096
ASV10288,84,279,139,233,231,701,428,2095
ASV1262,23,346,209,156,139,717,502,2092
ASV7768,88,214,488,277,288,362,374,2091
ASV7509,54,519,122,96,628,607,13,2039
ASV8450,96,314,206,239,396,461,323,2035
ASV924,24,22,27,1478,92,118,273,2034
ASV4617,22,25,1952,9,18,4,0,2030
ASV1094,36,174,546,452,262,179,377,2026
ASV2391,13,342,1091,199,74,176,125,2020
ASV2804,72,175,92,237,479,547,414,2016
ASV8352,1091,106,18,363,284,104,30,1996
ASV1867,72,240,81,192,215,525,645,1970
ASV26856,126,144,252,199,215,845,150,1931
ASV3817,208,123,473,410,255,209,248,1926
ASV17386,0,0,1884,0,0,32,0,1916
ASV23607,38,116,238,239,403,391,489,1914
ASV9739,35,182,239,41,709,671,36,1913
ASV612,152,72,101,379,123,83,984,1894
ASV667,21,619,113,765,4,31,322,1875
ASV12485,182,170,433,253,254,370,209,1871
ASV1476,0,22,882,200,156,531,54,1845
ASV6719,97,215,152,373,454,343,208,1842
ASV16048,1,317,880,0,36,568,20,1822
ASV994,209,523,254,214,190,176,248,1814
ASV4136,46,196,324,234,255,503,256,1814
ASV2277,74,124,306,400,344,228,325,1801
ASV8136,177,106,1144,138,40,19,168,1792
ASV13946,162,120,422,207,416,301,153,1781
ASV9154,106,138,450,317,253,308,204,1776
ASV1606,92,113,125,178,263,485,513,1769
ASV7497,100,145,408,283,318,303,204,1761
ASV2722,269,267,91,239,195,448,246,1755
ASV626,127,122,108,208,330,395,453,1743
ASV1969,62,252,69,176,240,470,470,1739
ASV1284,249,169,197,132,292,456,226,1721
ASV3058,221,211,299,227,264,245,254,1721
ASV8307,79,194,354,300,280,252,252,1711
ASV1086,52,105,281,210,496,355,194,1693
ASV4715,114,131,310,248,291,281,317,1692
ASV12666,10,94,229,797,227,258,62,1677
ASV524,59,133,343,253,214,245,424,1671
ASV649,89,77,316,170,473,415,130,1670
ASV8369,36,122,296,197,136,636,236,1659
ASV12765,58,181,369,22,160,373,485,1648
ASV3668,135,119,372,164,158,592,105,1645
ASV4123,9,73,220,606,645,43,48,1644
ASV11425,19,294,89,197,127,570,341,1637
ASV8628,28,54,424,534,72,460,57,1629
ASV2765,0,1,2,4,730,890,0,1627
ASV315,75,273,77,227,339,256,374,1621
ASV5168,56,117,329,141,155,465,349,1612
ASV9693,41,533,151,154,83,35,613,1610
ASV359,160,246,439,193,136,288,130,1592
ASV16064,130,143,328,277,262,178,266,1584
ASV3394,84,240,66,200,166,577,240,1573
ASV3231,107,74,320,247,303,430,84,1565
ASV9629,50,145,242,290,308,206,324,1565
ASV4400,77,102,407,247,199,342,190,1564
ASV3435,23,258,192,109,306,441,229,1558
ASV2766,41,250,122,150,284,379,327,1553
ASV515,0,15,0,1053,161,153,139,1521
ASV14171,0,650,789,0,48,14,16,1517
ASV226,88,129,245,436,190,239,187,1514
ASV1041,103,136,45,125,361,200,543,1513
ASV2778,117,192,169,194,342,215,283,1512
ASV2016,24,139,94,481,159,252,352,1501
ASV4108,49,164,352,186,160,192,398,1501
ASV4436,141,203,275,290,216,194,180,1499
ASV7781,128,178,54,150,287,369,328,1494
ASV3105,78,211,270,243,255,146,287,1490
ASV5300,164,232,110,149,261,326,239,1481
ASV724,77,189,236,267,343,194,169,1475
ASV2720,113,141,320,198,266,263,171,1472
ASV24123,80,215,100,209,224,344,298,1470
ASV4047,44,174,230,262,356,243,154,1463
ASV6131,29,311,3,152,677,259,11,1442
ASV2825,85,196,153,220,250,396,141,1441
ASV14632,269,305,98,134,389,114,131,1440
ASV2181,95,109,364,252,304,170,138,1432
ASV6983,0,83,718,21,90,418,97,1427
ASV2135,0,45,173,130,209,379,490,1426
ASV11586,0,0,5,1,849,552,0,1407
ASV4373,40,93,158,203,285,163,460,1402
ASV9700,4,21,0,48,1249,43,31,1396
ASV8756,45,55,146,947,80,88,33,1394
ASV4696,116,102,416,187,128,174,266,1389
ASV6884,30,109,192,254,275,177,333,1370
ASV9400,36,0,25,536,745,10,17,1369
ASV11129,18,105,333,134,102,97,577,1366
ASV6491,3,87,247,170,312,247,294,1360
ASV6005,120,332,196,93,268,113,236,1358
ASV15480,122,17,25,601,246,185,162,1358
ASV6621,0,71,349,234,644,0,57,1355
ASV950,20,87,47,92,91,614,392,1343
ASV5262,48,0,19,229,120,0,925,1341
ASV2256,45,179,244,94,180,215,382,1339
ASV2392,40,0,185,438,146,134,394,1337
ASV5838,82,165,271,304,186,120,209,1337
ASV295,37,117,313,280,145,271,170,1333
ASV16132,0,704,356,194,77,0,2,1333
ASV6354,101,135,214,194,281,139,260,1324
ASV11081,47,119,472,128,191,290,68,1315
ASV12749,103,18,1003,62,30,59,34,1309
ASV7374,72,78,193,90,223,529,116,1301
ASV13029,3,118,214,105,340,128,393,1301
ASV13598,219,130,212,45,199,302,194,1301
ASV4523,73,121,202,173,327,205,196,1297
ASV6461,167,222,239,177,146,212,126,1289
ASV926,74,90,247,96,106,260,415,1288
ASV19417,111,170,200,174,186,244,202,1287
ASV3167,82,237,28,149,284,266,232,1278
ASV8539,123,144,305,214,176,174,132,1268
ASV22227,63,137,178,128,209,336,214,1265
ASV6141,162,241,115,144,348,107,142,1259
ASV1717,52,59,135,519,145,264,84,1258
ASV1681,27,175,174,153,290,189,245,1253
ASV8529,30,139,136,108,137,501,201,1252
ASV5749,50,113,227,220,147,245,228,1230
ASV15210,80,121,3,175,157,413,257,1206
ASV17685,66,65,0,193,818,0,62,1204
ASV15012,95,105,177,233,290,190,97,1187
ASV382,9,77,627,80,263,63,65,1184
ASV3723,0,0,239,62,20,847,0,1168
ASV4507,110,74,264,141,84,357,125,1155
ASV1539,39,95,72,357,179,97,301,1140
ASV1526,58,55,247,175,203,159,235,1132
ASV19722,40,124,70,203,288,29,376,1130
ASV4989,8,82,435,30,76,258,237,1126
ASV9823,44,113,240,291,240,81,115,1124
ASV13622,24,173,0,594,93,0,240,1124
ASV3656,19,26,327,222,129,159,236,1118
ASV24824,42,254,56,104,201,229,219,1105
ASV6256,2,60,88,137,268,87,460,1102
ASV6757,62,83,82,234,290,16,332,1099
ASV21435,111,167,164,15,207,253,182,1099
ASV5857,42,0,0,0,157,791,105,1095
ASV3539,81,99,189,303,162,118,138,1090
ASV11076,107,126,221,170,129,192,143,1088
ASV19055,117,168,162,256,161,89,134,1087
ASV1382,335,23,41,199,204,28,256,1086
ASV716,22,453,218,86,122,89,92,1082
ASV5466,0,29,1032,0,11,4,0,1076
ASV6513,27,115,138,238,186,86,284,1074
ASV2851,56,28,18,657,49,140,115,1063
ASV5812,184,114,113,236,248,55,111,1061
ASV2088,48,135,52,120,149,310,238,1052
ASV1661,457,104,30,97,125,83,155,1051
ASV6703,4,4,202,573,17,248,0,1048
ASV10356,14,108,209,158,211,160,179,1039
ASV12591,82,92,240,148,133,103,233,1031
ASV2359,12,35,285,61,111,97,418,1019
ASV3198,1,26,326,34,257,350,22,1016
ASV4643,44,245,107,151,81,127,260,1015
ASV400,46,11,347,294,130,71,115,1014
ASV7554,41,34,75,502,89,48,225,1014
ASV14542,70,118,183,146,150,166,181,1014
ASV3318,13,71,284,110,183,208,144,1013
ASV6197,154,231,157,138,125,137,71,1013
ASV573,56,117,187,147,142,128,229,1006
ASV1305,62,74,242,137,142,190,154,1001
ASV12301,42,218,61,89,135,264,185,994
ASV7688,21,72,130,517,117,29,107,993
ASV8249,47,144,171,102,283,115,125,987
ASV8189,11,17,181,204,205,22,346,986
ASV8820,5,112,703,0,92,71,3,986
ASV3088,44,115,151,168,157,176,174,985
ASV4754,14,36,716,0,0,197,14,977
ASV1405,111,69,169,126,230,127,140,972
ASV5553,130,126,173,136,191,140,74,970
ASV5292,29,19,140,488,135,57,90,958
ASV25168,62,82,27,113,225,136,313,958
ASV478,20,341,32,153,153,149,107,955
ASV4202,90,99,152,120,291,92,111,955
ASV487,28,12,0,659,17,0,234,950
ASV21649,8,0,0,560,235,78,69,950
ASV2555,0,8,0,740,0,93,105,946
ASV4971,34,77,164,183,145,126,216,945
ASV3882,105,53,172,95,217,133,167,942
ASV5808,33,81,82,83,139,295,225,938
ASV1437,13,21,272,151,227,112,141,937
ASV2815,7,87,729,0,42,56,16,937
ASV1928,77,115,214,12,183,222,112,935
ASV2005,27,397,18,307,72,57,57,935
ASV10150,0,379,28,487,41,0,0,935
ASV2099,48,41,148,66,125,87,413,928
ASV13510,29,104,147,183,199,84,181,927
ASV6202,17,38,5,229,8,535,89,921
ASV4603,0,51,53,25,180,155,456,920
ASV2811,0,250,32,17,21,585,14,919
ASV1395,77,118,58,149,149,171,196,918
ASV14856,0,256,46,155,460,0,0,917
ASV18081,5,903,0,0,3,0,0,911
ASV960,3,90,249,72,169,127,195,905
ASV1011,48,96,84,194,200,94,188,904
ASV4391,3,5,455,194,114,9,122,902
ASV9469,49,120,165,105,56,158,248,901
ASV740,45,106,146,61,157,190,187,892
ASV6734,25,117,173,104,180,136,154,889
ASV3798,141,86,157,80,233,91,98,886
ASV4935,10,387,10,48,38,336,55,884
ASV5233,6,1,7,4,6,0,858,882
ASV7575,34,149,141,107,170,80,201,882
ASV11149,0,108,7,671,64,1,30,881
ASV9396,25,83,40,82,100,219,331,880
ASV6173,44,46,44,39,188,127,391,879
ASV12375,138,0,166,0,446,99,27,876
ASV871,29,111,242,65,182,147,96,872
ASV5206,60,74,263,123,219,59,74,872
ASV1581,23,43,228,68,161,271,75,869
ASV2762,66,80,212,95,149,89,159,850
ASV14786,43,93,203,129,142,132,106,848
ASV8979,69,105,169,42,233,189,39,846
ASV22556,9,71,187,76,63,161,277,844
ASV8687,0,61,665,82,0,24,6,838
ASV5906,10,232,192,84,118,51,150,837
ASV25080,1,8,828,0,0,0,0,837
ASV2089,4,38,486,68,138,41,61,836
ASV5122,36,121,168,116,88,185,120,834
ASV5235,52,50,60,170,194,81,225,832
ASV1864,14,107,177,163,94,141,133,829
ASV2185,11,218,135,413,24,0,28,829
ASV8849,63,76,207,137,117,160,66,826
ASV7911,0,3,0,55,726,16,24,824
ASV7258,47,62,208,138,310,31,25,821
ASV1574,21,42,1,352,203,24,177,820
ASV4470,93,91,67,132,186,129,121,819
ASV9915,50,78,39,185,109,94,261,816
ASV962,30,48,205,98,223,174,36,814
ASV2649,14,130,208,72,87,76,223,810
ASV8034,72,98,154,121,135,140,85,805
ASV10491,11,64,32,152,304,36,202,801
ASV12070,34,81,0,294,194,90,107,800
ASV3431,96,112,150,174,120,59,88,799
ASV1260,100,22,120,78,123,250,103,796
ASV22308,16,124,80,82,27,271,192,792
ASV6031,0,767,8,0,10,3,3,791
ASV2111,21,42,32,25,11,116,537,784
ASV15477,147,463,0,34,5,2,130,781
ASV12771,108,0,15,3,0,646,8,780
ASV1010,9,86,105,108,107,184,179,778
ASV2291,47,82,127,117,138,117,149,777
ASV9802,0,47,681,19,20,0,8,775
ASV4022,42,76,141,159,84,133,137,772
ASV12159,8,55,597,32,0,20,59,771
ASV11534,0,0,0,769,1,0,0,770
ASV6033,10,105,134,41,126,178,174,768
ASV3287,0,58,0,324,233,87,57,759
ASV8570,32,49,205,87,138,139,109,759
ASV1532,86,85,134,121,105,137,90,758
ASV5375,33,31,63,428,35,81,87,758
ASV3361,21,19,135,52,90,41,398,756
ASV1722,12,106,160,112,87,143,135,755
ASV12361,63,61,102,216,123,25,160,750
ASV963,70,55,118,137,127,101,141,749
ASV19379,0,0,0,65,679,0,0,744
ASV5157,60,28,145,161,100,138,104,736
ASV6959,21,78,144,87,70,175,160,735
ASV12888,0,0,19,0,0,716,0,735
ASV12976,51,58,197,127,107,110,83,733
ASV294,2,32,200,129,132,153,84,732
ASV1196,21,13,197,50,97,150,203,731
ASV3408,15,36,161,160,188,73,97,730
ASV392,6,0,18,0,16,379,310,729
ASV5196,19,81,173,68,42,88,258,729
ASV9406,10,65,130,119,100,123,181,728
ASV6246,46,74,149,99,141,106,109,724
ASV10272,26,42,187,123,122,74,147,721
ASV1349,17,54,39,64,121,108,316,719
ASV1859,19,88,34,86,434,19,39,719
ASV17816,0,102,159,1,46,70,341,719
ASV1161,59,28,197,124,55,149,106,718
ASV1193,19,111,205,68,142,76,97,718
ASV3423,7,221,0,263,55,5,166,717
ASV6612,29,85,151,81,137,160,73,716
ASV20782,15,562,66,0,0,39,34,716
ASV3695,13,53,39,63,62,201,284,715
ASV3383,20,43,195,114,78,86,178,714
ASV1241,115,0,0,249,312,0,37,713
ASV10069,60,46,123,139,119,72,152,711
ASV14904,84,99,83,134,137,97,76,710
ASV12535,61,98,143,113,87,84,122,708
ASV1660,35,46,98,114,137,59,215,704
ASV1444,67,38,134,235,65,78,82,699
ASV937,25,33,185,106,84,92,172,697
ASV1188,36,59,171,66,57,94,214,697
ASV15635,93,61,154,111,109,99,70,697
ASV4988,80,69,131,69,158,117,72,696
ASV8597,61,64,161,94,135,108,73,696
ASV3174,20,60,160,97,60,90,208,695
ASV3470,28,107,159,164,83,94,60,695
ASV4806,36,127,123,86,96,90,136,694
ASV258,46,81,87,142,137,152,47,692
ASV1432,112,78,67,157,146,65,67,692
ASV4844,0,2,86,0,0,604,0,692
ASV4918,51,86,118,161,93,103,78,690
ASV15535,62,14,89,87,277,114,47,690
ASV10135,52,41,138,94,183,81,98,687
ASV8221,1,21,160,48,72,111,270,683
ASV7860,0,0,180,63,28,253,157,681
ASV946,108,19,39,107,169,62,175,679
ASV1752,50,94,113,96,103,107,116,679
ASV3190,43,52,419,102,19,0,43,678
ASV4912,75,81,131,99,105,72,114,677
ASV1883,63,61,115,64,147,88,137,675
ASV4014,10,31,452,0,4,157,20,674
ASV23186,33,52,191,102,129,101,65,673
ASV5430,50,85,51,230,51,114,90,671
ASV815,26,14,159,143,142,83,103,670
ASV11277,15,0,138,0,1,52,460,666
ASV5167,57,123,110,76,82,87,129,664
ASV5613,35,87,89,93,164,89,107,664
ASV7493,40,48,131,114,120,127,84,664
ASV2062,42,67,92,53,109,68,229,660
ASV3263,0,0,128,0,530,0,0,658
ASV4088,27,88,116,114,61,124,128,658
ASV15263,0,67,34,74,36,246,201,658
ASV7990,60,11,267,120,101,56,41,656
ASV6362,57,89,99,140,107,43,120,655
ASV7486,0,0,0,0,0,655,0,655
ASV5598,73,56,117,71,127,61,149,654
ASV1964,24,30,35,67,27,365,104,652
ASV6479,35,130,41,28,97,279,42,652
ASV10018,70,64,74,108,175,56,105,652
ASV2241,23,60,88,45,87,164,183,650
ASV3410,37,99,41,71,65,213,124,650
ASV24648,29,166,38,54,10,245,106,648
ASV10043,0,0,0,0,0,0,646,646
ASV821,56,69,108,57,37,130,187,644
ASV9490,55,49,112,98,108,135,86,643
ASV155,49,56,88,172,166,35,75,641
ASV430,0,0,67,193,215,19,140,634
ASV2663,23,106,104,58,113,151,75,630
ASV2759,3,9,79,109,63,270,97,630
ASV11695,27,4,0,74,306,0,217,628
ASV12800,31,34,85,163,160,60,95,628
ASV111,59,93,26,51,78,151,163,621
ASV11740,0,619,0,0,0,0,2,621
ASV1828,87,38,103,82,104,130,76,620
ASV2007,14,26,101,226,35,188,27,617
ASV3845,0,59,130,66,98,205,57,615
ASV5596,15,46,174,132,120,21,107,615
ASV20288,18,85,0,226,238,27,19,613
ASV3239,207,51,83,132,23,87,29,612
ASV17957,17,98,39,35,85,215,121,610
ASV25937,8,59,170,54,202,62,54,609
ASV3377,26,92,98,107,130,36,117,606
ASV5378,27,101,133,43,114,160,28,606
ASV219,26,24,101,110,114,188,40,603
ASV3586,148,176,63,27,89,34,65,602
ASV2390,48,33,129,71,91,79,150,601
ASV2680,3,42,53,22,54,367,59,600
ASV5095,0,156,36,335,0,71,0,598
ASV1694,43,60,133,129,96,71,65,597
ASV7103,0,185,6,31,1,0,372,595
ASV2845,41,42,70,73,199,25,144,594
ASV19393,91,46,52,28,45,166,165,593
ASV5323,7,259,0,324,0,0,2,592
ASV5355,54,40,106,75,113,96,108,592
ASV17801,0,58,534,0,0,0,0,592
ASV5259,17,23,294,152,16,33,55,590
ASV16615,32,123,0,328,3,0,104,590
ASV8050,166,44,4,26,87,208,54,589
ASV12712,59,50,64,150,166,69,31,589
ASV6623,15,67,58,30,42,206,170,588
ASV2532,6,35,146,90,97,93,119,586
ASV277,82,59,132,85,122,59,46,585
ASV5660,14,66,41,109,98,125,132,585
ASV721,13,48,88,83,170,77,104,583
ASV835,63,141,79,70,104,71,55,583
ASV3020,20,45,101,67,127,87,136,583
ASV3610,41,38,56,83,199,90,71,578
ASV5670,21,0,13,416,0,125,0,575
ASV3092,36,67,77,111,75,103,102,571
ASV11538,71,61,105,62,155,60,53,567
ASV2474,37,77,60,97,102,47,146,566
ASV6628,46,113,164,57,17,128,39,564
ASV928,9,18,51,14,55,412,3,562
ASV1690,40,20,102,138,93,42,127,562
ASV5712,0,85,114,24,103,70,165,561
ASV8537,13,39,31,53,104,111,205,556
ASV10040,23,37,98,98,97,50,153,556
ASV744,22,97,112,92,73,79,80,555
ASV1253,6,45,157,84,74,73,116,555
ASV8917,14,76,98,161,89,51,65,554
ASV18243,18,40,84,44,240,99,28,553
ASV5093,0,0,242,0,271,10,29,552
ASV2052,83,73,122,59,104,59,51,551
ASV11108,7,49,83,50,64,133,164,550
ASV3082,74,56,80,38,48,190,63,549
ASV12065,55,44,27,97,153,7,166,549
ASV1701,30,162,24,113,6,176,37,548
ASV4713,25,68,104,94,104,69,83,547
ASV2645,9,133,2,104,127,87,84,546
ASV2977,7,53,134,41,92,119,100,546
ASV474,52,44,99,92,140,25,92,544
ASV10824,0,18,234,111,22,154,2,541
ASV4331,23,80,379,0,21,18,19,540
ASV5177,26,46,21,64,223,9,151,540
ASV8676,4,37,181,40,14,130,134,540
ASV10414,14,49,141,49,96,166,25,540
ASV5063,9,102,15,27,13,196,177,539
ASV16972,4,47,91,94,102,110,90,538
ASV12342,6,31,46,3,13,9,429,537
ASV8396,14,174,51,4,8,15,270,536
ASV20947,35,165,71,72,57,69,67,536
ASV10920,32,0,4,151,343,2,3,535
ASV5493,35,107,75,74,115,29,99,534
ASV17160,16,64,126,39,66,110,112,533
ASV6529,16,29,53,41,113,130,149,531
ASV8051,53,3,110,68,94,148,55,531
ASV1808,97,72,79,68,37,154,23,530
ASV290,36,36,84,56,67,104,146,529
ASV6026,8,57,120,80,127,28,109,529
ASV6517,14,113,23,165,26,68,119,528
ASV1,261,48,47,43,35,35,58,527
ASV4158,24,19,90,50,175,68,101,527
ASV10519,9,31,145,243,75,22,1,526
ASV4002,0,20,83,206,13,101,102,525
ASV4064,38,35,80,40,112,143,77,525
ASV6045,4,48,92,108,78,98,97,525
ASV6146,4,25,147,183,68,42,56,525
ASV10810,42,49,29,63,165,40,135,523
ASV1896,0,44,47,98,76,191,65,521
ASV6861,30,266,82,6,7,110,20,521
ASV10354,41,65,33,92,155,36,98,520
ASV3567,31,42,70,89,112,61,113,518
ASV846,0,58,92,13,135,45,174,517
ASV866,0,27,95,81,192,80,42,517
ASV3726,8,42,197,92,140,10,28,517
ASV10473,36,57,95,70,106,87,66,517
ASV3254,15,67,109,93,95,83,54,516
ASV3458,50,14,418,0,0,34,0,516
ASV9720,0,40,86,54,86,99,151,516
ASV9874,43,31,50,96,132,53,109,514
ASV4159,21,36,72,122,108,44,110,513
ASV7661,0,0,248,0,52,0,213,513
ASV6328,104,10,19,124,108,0,147,512
ASV19161,8,27,181,77,88,64,66,511
ASV10432,8,54,0,126,36,68,217,509
ASV4281,51,61,76,68,73,56,122,507
ASV18802,40,60,62,79,78,109,79,507
ASV1781,11,77,76,105,109,49,79,506
ASV2607,58,57,127,104,48,78,34,506
ASV3637,0,70,53,45,50,119,169,506
ASV9242,31,80,86,121,74,55,59,506
ASV4212,28,17,51,105,156,76,72,505
ASV8105,19,22,114,100,100,78,70,503
ASV2155,5,0,0,5,492,0,0,502
ASV5667,6,5,185,89,81,96,40,502
ASV1499,20,85,91,40,123,52,90,501
ASV1634,0,109,0,384,7,0,0,500
ASV4195,0,18,112,22,10,22,316,500
ASV1093,21,54,99,49,46,89,140,498
ASV14285,9,65,48,254,60,26,35,497
ASV21984,0,0,0,0,496,0,0,496
ASV7270,0,22,90,100,95,110,78,495
ASV8169,3,15,106,131,13,115,110,493
ASV809,134,43,16,161,68,53,15,490
ASV9475,50,22,15,42,41,0,318,488
ASV18586,33,46,18,212,107,17,53,486
ASV1372,66,37,67,18,99,139,59,485
ASV8185,3,44,75,0,22,3,338,485
ASV1130,74,34,105,47,59,129,33,481
ASV332,10,0,98,0,45,123,203,479
ASV6500,13,83,38,23,39,132,151,479
ASV8808,42,74,86,78,70,68,60,478
ASV7967,6,33,111,51,60,114,99,474
ASV4309,0,9,61,22,164,85,132,473
ASV16454,1,17,39,67,182,117,50,473
ASV323,16,55,85,33,162,72,47,470
ASV2786,14,66,89,67,88,36,110,470
ASV157,24,23,0,157,173,3,89,469
ASV168,32,10,74,28,99,59,167,469
ASV3258,38,19,44,48,171,36,113,469
ASV984,191,17,43,63,25,120,9,468
ASV1819,40,38,60,93,157,58,21,467
ASV425,0,36,0,129,35,200,66,466
ASV2129,58,17,11,17,183,16,164,466
ASV6828,36,22,102,97,110,89,10,466
ASV2972,15,60,124,80,45,46,95,465
ASV8056,6,51,53,76,38,54,187,465
ASV2281,67,69,63,93,118,34,18,462
ASV1236,0,30,199,17,23,121,71,461
ASV1898,0,37,138,100,41,103,42,461
ASV8637,17,35,5,109,136,19,140,461
ASV749,43,43,98,101,76,76,20,457
ASV6368,60,14,52,104,0,142,85,457
ASV7150,5,18,69,70,92,88,115,457
ASV7606,32,96,96,25,37,123,48,457
ASV2753,2,32,126,55,38,199,3,455
ASV4535,0,0,5,59,196,83,112,455
ASV21330,0,5,0,180,270,0,0,455
ASV2481,0,27,25,115,155,129,3,454
ASV1963,5,25,113,82,80,48,99,452
ASV4146,3,29,17,74,95,87,147,452
ASV5442,9,42,83,41,110,82,83,450
ASV10391,38,26,107,74,46,115,44,450
ASV10322,12,36,98,49,42,160,52,449
ASV1023,24,33,40,72,93,109,77,448
ASV4868,12,54,78,73,80,68,83,448
ASV9304,0,0,155,0,28,0,264,447
ASV9383,33,49,87,75,46,111,46,447
ASV10595,27,36,87,88,71,49,89,447
ASV18004,26,29,86,82,52,103,66,444
ASV2848,28,29,83,36,106,116,45,443
ASV6264,22,15,25,73,122,104,82,443
ASV1619,11,335,0,10,6,78,0,440
ASV18858,11,41,31,46,73,104,134,440
ASV92,25,40,39,91,124,12,108,439
ASV1879,118,122,4,12,61,50,72,439
ASV6880,43,51,101,64,85,64,30,438
ASV5238,222,46,0,21,80,57,10,436
ASV4238,60,13,16,61,10,231,44,435
ASV2903,21,36,93,46,67,60,111,434
ASV5172,36,68,78,73,87,39,53,434
ASV7035,0,33,21,184,13,58,125,434
ASV319,38,42,63,81,26,103,79,432
ASV5075,21,135,2,79,70,71,54,432
ASV2038,0,0,27,42,20,342,0,431
ASV741,30,98,74,95,64,33,36,430
ASV4509,31,62,79,81,64,46,65,428
ASV393,40,38,18,48,121,56,106,427
ASV3429,14,42,75,81,65,61,88,426
ASV11641,0,16,142,24,122,36,85,425
ASV5001,11,142,1,93,55,122,0,424
ASV1765,16,19,90,52,73,80,93,423
ASV2800,12,34,73,78,86,95,45,423
ASV12818,0,17,364,0,0,38,3,422
ASV3754,44,38,50,55,108,20,104,419
ASV8202,0,35,145,35,10,36,158,419
ASV3027,12,8,47,30,112,132,77,418
ASV869,24,30,112,51,12,116,71,416
ASV2389,6,24,25,68,136,49,107,415
ASV16792,1,27,83,16,77,86,125,415
ASV17091,0,415,0,0,0,0,0,415
ASV5958,19,57,86,85,68,61,38,414
ASV2648,33,95,82,46,58,72,25,411
ASV6936,21,63,53,45,100,31,97,410
ASV7784,53,43,96,81,43,59,35,410
ASV8282,11,216,13,39,37,32,62,410
ASV8452,8,43,83,74,80,58,64,410
ASV848,10,27,140,23,15,43,150,408
ASV1768,2,26,87,68,41,56,128,408
ASV3579,9,29,81,55,91,47,96,408
ASV17088,36,48,69,68,64,57,65,407
ASV1413,16,74,126,52,58,53,26,405
ASV14661,21,18,28,10,8,68,252,405
ASV4420,5,64,40,32,19,13,231,404
ASV4478,7,32,76,153,84,19,31,402
ASV16874,23,0,33,107,153,4,82,402
ASV21622,8,95,72,24,87,33,83,402
ASV7042,10,6,94,63,62,70,96,401
ASV1850,0,35,104,33,54,82,92,400
ASV2298,14,45,120,78,56,40,47,400
ASV19614,21,37,10,27,153,46,106,400
ASV209,8,26,109,55,107,39,55,399
ASV1814,77,15,0,21,248,19,19,399
ASV12239,41,198,1,103,10,37,9,399
ASV18492,4,0,184,32,5,134,40,399
ASV2475,23,56,68,79,79,60,33,398
ASV3061,15,9,186,54,0,133,0,397
ASV13793,9,14,98,55,38,130,52,396
ASV1215,22,57,41,48,84,50,93,395
ASV4353,174,46,24,17,51,32,51,395
ASV14108,28,34,55,41,60,73,104,395
ASV3108,0,27,100,66,145,52,4,394
ASV5058,13,59,79,30,50,110,53,394
ASV13273,27,139,38,130,17,37,6,394
ASV4273,37,15,80,62,90,38,71,393
ASV4946,34,16,71,63,26,166,17,393
ASV9505,6,31,70,74,96,68,48,393
ASV4780,0,99,51,76,53,46,66,391
ASV5279,3,16,30,100,72,7,163,391
ASV10183,10,37,99,94,95,44,12,391
ASV1750,5,0,384,0,0,0,0,389
ASV1008,3,47,2,109,139,0,87,387
ASV7077,0,0,15,25,58,32,257,387
ASV230,0,25,120,49,59,103,30,386
ASV3518,15,105,35,64,66,47,54,386
ASV3851,35,24,28,54,160,15,69,385
ASV4782,47,28,45,101,8,109,45,383
ASV11612,4,11,78,46,77,77,90,383
ASV8421,20,28,127,95,50,43,19,382
ASV2859,16,13,91,89,73,62,37,381
ASV10343,54,95,153,37,23,10,8,380
ASV15519,17,23,63,105,82,56,34,380
ASV15310,17,46,81,55,60,64,56,379
ASV17745,23,41,74,67,54,51,68,378
ASV24583,0,0,0,227,2,12,136,377
ASV5864,4,35,76,87,56,64,53,375
ASV8817,72,73,39,61,71,42,17,375
ASV2988,4,12,80,63,76,38,101,374
ASV5071,8,17,48,8,17,158,118,374
ASV8751,0,104,12,0,12,39,207,374
ASV16378,55,43,34,85,65,50,42,374
ASV17990,0,35,0,20,0,243,76,374
ASV1849,13,59,85,39,41,94,42,373
ASV5490,0,14,39,170,29,57,63,372
ASV18760,27,11,86,87,37,21,102,371
ASV6148,52,5,171,59,71,0,12,370
ASV589,0,3,88,25,116,73,64,369
ASV4226,0,47,46,22,10,235,9,369
ASV5813,10,19,77,87,97,13,66,369
ASV9837,0,147,0,93,103,25,0,368
ASV1047,0,31,36,37,105,117,41,367
ASV2168,0,0,0,342,0,25,0,367
ASV4337,0,48,107,46,48,117,0,366
ASV6927,26,58,102,38,64,63,15,366
ASV10247,8,70,40,57,123,10,58,366
ASV12713,5,1,19,251,1,57,32,366
ASV18158,0,0,18,186,4,39,119,366
ASV23164,12,22,57,42,68,134,30,365
ASV1264,10,84,4,32,63,165,6,364
ASV7775,32,87,86,71,33,25,29,363
ASV9949,0,26,84,84,24,30,115,363
ASV6741,14,49,94,126,19,3,56,361
ASV8512,0,23,140,14,105,47,32,361
ASV3648,49,34,93,31,65,50,38,360
ASV7920,28,62,57,20,103,16,74,360
ASV5065,26,7,25,37,129,123,12,359
ASV483,44,19,36,40,86,42,90,357
ASV2372,35,18,91,41,76,63,33,357
ASV4721,17,34,69,37,62,51,87,357
ASV836,95,27,71,33,70,23,37,356
ASV8454,0,0,0,12,45,10,289,356
ASV16916,0,301,2,12,18,15,8,356
ASV4685,4,9,84,0,45,149,64,355
ASV10655,58,45,49,38,29,58,78,355
ASV2865,0,218,84,0,26,21,5,354
ASV8920,20,8,107,16,147,4,52,354
ASV9311,6,116,2,0,5,225,0,354
ASV3912,0,43,45,54,77,53,81,353
ASV23199,39,12,116,40,141,0,3,351
ASV7640,5,40,81,60,95,24,45,350
ASV2151,38,11,100,21,39,17,123,349
ASV10838,9,38,40,8,3,249,2,349
ASV10939,18,45,16,21,8,126,115,349
ASV6419,0,0,6,0,0,342,0,348
ASV14912,20,29,40,88,87,13,71,348
ASV18099,0,183,65,21,0,79,0,348
ASV6667,0,0,1,45,125,2,173,346
ASV532,12,15,42,61,99,16,99,344
ASV10907,24,13,47,97,104,27,30,342
ASV3945,0,0,0,22,319,0,0,341
ASV4576,24,35,110,47,56,22,47,341
ASV22192,27,19,73,61,73,52,36,341
ASV9286,0,42,87,36,33,117,25,340
ASV11992,75,32,207,0,2,14,10,340
ASV725,1,0,112,112,49,44,21,339
ASV2169,12,207,10,41,11,35,23,339
ASV3010,0,118,26,35,25,106,28,338
ASV2409,0,112,15,32,25,9,144,337
ASV5311,0,30,77,45,74,53,58,337
ASV16882,0,35,20,10,25,159,88,337
ASV4084,3,15,33,160,11,49,65,336
ASV181,0,0,325,6,4,0,0,335
ASV3516,21,26,65,44,93,45,41,335
ASV8746,30,34,67,54,58,53,39,335
ASV9551,12,36,22,119,69,6,71,335
ASV3086,81,34,56,1,32,73,57,334
ASV4052,8,13,39,29,25,29,191,334
ASV5887,0,0,9,22,23,279,0,333
ASV5125,0,198,29,12,10,52,31,332
ASV8203,30,42,28,51,40,64,77,332
ASV5956,19,40,66,101,53,13,39,331
ASV6800,14,105,68,0,77,5,62,331
ASV7277,14,29,39,55,128,5,61,331
ASV13300,10,68,27,56,53,49,67,330
ASV4370,0,16,100,36,68,66,43,329
ASV4901,25,43,35,54,65,53,54,329
ASV15247,51,2,45,80,57,57,36,328
ASV6809,0,39,75,42,86,23,62,327
ASV8601,12,40,37,114,81,19,24,327
ASV12905,0,36,19,46,17,173,36,327
ASV8035,1,25,7,101,69,108,14,325
ASV2136,51,23,68,58,33,26,65,324
ASV6866,0,34,253,28,0,0,9,324
ASV7051,0,114,75,63,22,30,20,324
ASV12903,53,85,14,23,91,20,36,322
ASV2489,33,52,24,72,57,34,49,321
ASV5171,37,30,82,25,62,31,53,320
ASV7010,11,18,64,100,87,36,4,320
ASV8839,11,26,207,15,17,5,39,320
ASV5716,0,21,39,82,69,51,57,319
ASV10659,57,76,49,97,17,17,6,319
ASV3683,24,26,58,71,38,65,36,318
ASV9520,4,50,87,62,61,40,14,318
ASV13695,7,7,235,11,27,30,1,318
ASV488,13,34,55,42,80,68,25,317
ASV12926,0,254,34,0,29,0,0,317
ASV1697,3,8,14,70,52,32,137,316
ASV2747,43,24,42,36,94,37,40,316
ASV3828,0,71,0,33,66,66,80,316
ASV12261,32,31,44,81,33,48,47,316
ASV11907,9,11,78,54,58,34,71,315
ASV10730,0,4,94,65,22,123,6,314
ASV201,18,27,53,63,51,41,60,313
ASV897,55,37,69,32,47,35,38,313
ASV3273,6,8,68,104,56,37,34,313
ASV5227,31,18,32,62,76,46,48,313
ASV11591,18,36,46,27,45,60,81,313
ASV892,0,9,9,92,95,10,97,312
ASV3463,0,29,128,74,22,50,9,312
ASV7529,0,4,0,6,3,4,294,311
ASV2411,37,22,47,24,35,41,103,309
ASV2836,0,0,34,11,44,44,175,308
ASV5882,24,38,64,15,55,28,84,308
ASV15677,0,0,0,0,308,0,0,308
ASV2579,0,0,0,307,0,0,0,307
ASV9456,11,43,84,51,73,22,23,307
ASV802,14,216,11,12,14,33,6,306
ASV5483,1,19,31,6,7,240,2,306
ASV7436,4,26,64,37,96,25,54,306
ASV9485,0,0,4,111,6,141,43,305
ASV7243,0,0,75,207,18,4,0,304
ASV2717,0,0,0,303,0,0,0,303
ASV13470,0,14,50,101,49,46,43,303
ASV361,3,11,39,66,55,87,39,300
ASV1042,40,26,57,37,66,32,42,300
ASV3543,5,41,84,36,67,33,34,300
ASV3804,47,72,38,41,7,34,61,300
ASV4533,0,31,9,99,17,0,144,300
ASV13307,21,25,40,19,102,65,28,300
ASV16934,32,18,77,29,36,58,50,300
ASV24208,39,34,68,63,38,30,28,300
ASV2046,1,52,31,59,15,104,36,298
ASV4926,90,25,36,35,45,18,49,298
ASV16445,0,0,0,289,0,9,0,298
ASV15008,0,0,0,297,0,0,0,297
ASV1067,0,34,75,38,60,48,41,296
ASV4832,29,15,56,59,48,20,69,296
ASV3017,0,79,165,9,2,6,33,294
ASV16319,14,4,2,43,230,0,1,294
ASV8789,28,19,13,77,76,33,47,293
ASV12750,0,13,78,13,7,181,1,293
ASV13810,20,21,45,35,49,95,28,293
ASV1142,15,29,78,75,38,37,20,292
ASV2683,0,82,25,69,39,40,36,291
ASV452,29,18,56,55,51,30,51,290
ASV9339,0,0,0,275,12,0,3,290
ASV12919,11,41,71,18,29,51,69,290
ASV1988,0,11,78,50,46,44,60,289
ASV2471,0,15,4,29,35,62,144,289
ASV3590,13,51,59,34,58,36,38,289
ASV1239,0,0,0,0,0,0,288,288
ASV4426,12,48,58,25,47,71,27,288
ASV14281,37,18,41,38,38,75,41,288
ASV17877,0,7,21,57,135,39,29,288
ASV3452,27,42,19,20,75,34,70,287
ASV3199,0,0,0,240,0,17,29,286
ASV3417,0,35,61,19,37,45,89,286
ASV2029,29,46,37,16,38,39,80,285
ASV1402,2,5,139,13,21,44,60,284
ASV5435,0,0,233,0,0,51,0,284
ASV1178,109,22,7,0,14,122,9,283
ASV14947,0,0,164,33,86,0,0,283
ASV23662,0,32,70,22,67,33,59,283
ASV1030,19,3,26,37,55,36,106,282
ASV10739,11,0,0,221,0,48,2,282
ASV11959,11,27,44,67,63,13,57,282
ASV10430,34,10,65,63,56,42,11,281
ASV14596,18,5,48,38,75,58,39,281
ASV6839,9,0,105,141,25,0,0,280
ASV1085,0,2,3,10,184,0,80,279
ASV2332,59,43,86,13,71,4,3,279
ASV15228,0,3,0,0,276,0,0,279
ASV5972,0,45,4,3,1,0,225,278
ASV18144,47,40,29,66,41,40,14,277
ASV18819,0,47,78,42,70,17,23,277
ASV1290,0,18,72,16,5,52,113,276
ASV3169,13,17,69,43,24,49,61,276
ASV3983,0,240,0,0,16,11,9,276
ASV18413,0,17,133,14,95,13,4,276
ASV5880,0,0,0,0,0,0,275,275
ASV6723,24,57,39,58,22,44,31,275
ASV6797,5,63,16,35,109,40,7,275
ASV3344,41,13,62,23,50,41,44,274
ASV7662,6,8,55,63,20,58,64,274
ASV11026,80,20,31,40,31,57,15,274
ASV7664,6,23,44,18,35,58,89,273
ASV23011,0,24,7,5,10,187,40,273
ASV3858,12,40,28,65,61,46,20,272
ASV4759,67,8,96,12,0,72,17,272
ASV9933,7,2,0,105,54,42,62,272
ASV10133,64,0,94,63,19,24,8,272
ASV11122,34,14,45,32,71,35,40,271
ASV679,17,44,45,51,64,16,33,270
ASV862,0,0,270,0,0,0,0,270
ASV920,0,7,21,55,87,47,53,270
ASV2500,0,15,0,174,50,2,29,270
ASV6299,0,0,0,0,0,0,270,270
ASV2176,0,14,174,32,33,0,16,269
ASV2962,2,13,40,48,57,49,60,269
ASV9906,0,269,0,0,0,0,0,269
ASV11886,8,4,57,56,28,27,89,269
ASV14508,4,34,82,44,40,24,41,269
ASV15482,0,63,14,25,61,0,106,269
ASV2021,52,3,26,28,80,55,24,268
ASV1356,7,64,5,119,17,8,47,267
ASV4944,5,16,83,74,44,30,15,267
ASV6751,0,121,0,43,66,0,37,267
ASV15121,0,0,0,266,0,0,0,266
ASV5434,0,65,52,10,52,31,55,265
ASV12445,3,14,29,94,39,26,60,265
ASV2615,90,13,12,74,8,23,44,264
ASV3378,33,13,24,47,60,19,68,264
ASV3844,0,6,36,26,43,49,103,263
ASV5414,0,22,69,13,12,122,25,263
ASV10829,33,11,9,18,100,7,84,262
ASV19933,2,19,65,62,23,88,3,262
ASV643,0,27,32,45,26,65,66,261
ASV1797,19,32,40,55,81,21,13,261
ASV8334,11,5,6,120,20,94,5,261
ASV3048,7,20,26,20,42,21,124,260
ASV10704,95,0,2,11,22,6,124,260
ASV1400,0,23,30,45,24,28,109,259
ASV13742,0,0,62,0,108,79,10,259
ASV101,0,25,25,117,19,4,68,258
ASV26275,0,21,21,88,51,40,37,258
ASV4340,0,33,88,44,20,46,26,257
ASV6225,0,208,7,0,8,32,2,257
ASV11116,2,29,57,36,53,20,60,257
ASV14449,2,16,87,31,28,70,23,257
ASV14480,0,0,0,0,248,7,2,257
ASV19566,9,65,3,3,159,4,14,257
ASV3422,37,44,49,27,31,55,13,256
ASV3768,17,33,15,71,63,28,29,256
ASV10389,6,30,70,20,61,45,24,256
ASV8933,11,41,39,46,25,21,72,255
ASV21993,32,56,0,77,66,0,24,255
ASV512,4,33,48,49,14,40,66,254
ASV965,13,70,25,52,33,61,0,254
ASV6516,7,6,65,98,58,15,5,254
ASV12412,18,18,41,38,65,48,26,254
ASV15015,0,0,49,84,102,19,0,254
ASV25770,0,0,0,0,23,0,231,254
ASV2933,0,26,3,37,108,15,64,253
ASV3029,0,0,0,58,68,10,117,253
ASV3597,122,15,17,27,29,17,26,253
ASV8140,1,15,36,40,49,55,57,253
ASV253,8,26,67,5,2,110,34,252
ASV882,0,8,83,68,23,34,36,252
ASV10104,1,63,26,8,25,27,102,252
ASV11175,9,66,2,45,77,45,8,252
ASV3392,25,21,38,107,2,33,25,251
ASV4954,0,0,33,11,7,197,3,251
ASV10511,44,16,50,5,80,21,35,251
ASV11490,0,34,76,119,13,0,9,251
ASV11941,0,0,0,145,33,0,73,251
ASV385,26,19,25,60,33,52,35,250
ASV445,5,26,78,8,6,42,85,250
ASV4815,0,15,44,25,75,71,20,250
ASV15950,18,12,110,63,26,10,11,250
ASV195,0,113,0,37,0,69,30,249
ASV1786,4,21,65,20,34,33,72,249
ASV5780,10,44,36,55,49,19,36,249
ASV10409,4,14,82,30,21,43,54,248
ASV12995,19,0,7,52,153,4,13,248
ASV894,7,15,44,31,29,45,76,247
ASV1839,31,3,58,90,32,9,24,247
ASV9448,33,18,0,0,49,45,102,247
ASV11587,0,0,0,0,0,247,0,247
ASV2681,18,64,7,12,48,15,82,246
ASV6897,0,35,8,94,51,35,23,246
ASV6934,5,14,31,41,97,11,47,246
ASV2352,3,40,76,8,10,35,72,244
ASV7766,0,15,60,22,12,78,57,244
ASV19396,0,11,55,63,70,36,9,244
ASV23834,0,25,0,1,0,0,218,244
ASV16,3,28,57,39,70,5,41,243
ASV807,0,17,38,24,39,41,84,243
ASV5791,38,30,50,29,35,33,28,243
ASV7223,25,28,51,51,36,37,15,243
ASV19972,10,23,29,61,71,9,40,243
ASV4748,14,57,0,97,0,0,73,241
ASV11180,0,2,2,221,10,6,0,241
ASV12081,2,0,54,64,52,53,16,241
ASV18922,30,25,22,34,88,19,23,241
ASV156,15,19,50,32,36,22,66,240
ASV7698,2,48,94,16,6,19,55,240
ASV12525,0,26,26,30,75,24,59,240
ASV24512,11,2,21,51,28,0,127,240
ASV1426,1,7,67,43,115,0,6,239
ASV1575,3,23,17,36,24,0,136,239
ASV2330,21,25,32,44,23,51,42,238
ASV4626,6,6,82,21,52,69,2,238
ASV6729,0,0,128,0,3,78,29,238
ASV14257,7,27,53,15,61,60,15,238
ASV17007,12,38,19,91,48,16,14,238
ASV422,6,13,53,98,19,15,33,237
ASV5463,29,16,18,56,61,36,21,237
ASV10316,0,25,19,122,45,15,11,237
ASV61,11,27,43,37,24,40,54,236
ASV1424,0,187,0,0,0,49,0,236
ASV1946,31,38,43,41,41,22,20,236
ASV2172,9,2,77,35,23,17,73,236
ASV5334,8,10,58,31,53,25,51,236
ASV611,24,18,48,21,35,56,33,235
ASV11653,5,51,30,20,46,30,53,235
ASV269,0,53,68,41,13,29,30,234
ASV3329,0,31,17,33,51,18,84,234
ASV5461,4,39,65,27,20,42,37,234
ASV5820,1,24,36,68,33,20,52,234
ASV7729,12,9,47,35,15,49,67,234
ASV12454,24,0,47,21,36,41,65,234
ASV3085,0,29,11,0,47,15,131,233
ASV9556,0,71,85,10,21,33,13,233
ASV18841,74,50,0,66,11,0,32,233
ASV463,13,32,49,50,32,14,42,232
ASV719,7,14,64,11,37,20,79,232
ASV19232,0,15,0,175,9,1,32,232
ASV3173,27,31,24,42,37,45,25,231
ASV5010,9,15,37,28,48,81,13,231
ASV6138,10,0,32,20,64,43,61,230
ASV7207,2,10,34,94,21,8,61,230
ASV7677,8,24,63,24,26,14,71,230
ASV225,5,27,30,47,26,31,63,229
ASV6989,5,14,41,42,32,39,55,228
ASV10985,28,13,52,30,30,45,30,228
ASV12098,12,23,58,34,15,38,48,228
ASV13036,2,8,54,143,21,0,0,228
ASV21118,19,29,30,23,89,12,26,228
ASV22626,17,24,44,54,15,27,47,228
ASV391,7,37,47,21,39,25,51,227
ASV3299,30,0,0,5,77,105,10,227
ASV8498,4,12,53,4,19,67,68,227
ASV9347,5,12,84,25,3,70,27,226
ASV13279,0,0,0,1,11,213,1,226
ASV1385,0,23,31,31,28,23,89,225
ASV4583,30,53,26,20,56,21,19,225
ASV14317,3,8,37,27,34,65,51,225
ASV17568,58,21,29,50,36,11,20,225
ASV19420,0,9,13,13,3,0,187,225
ASV1182,0,4,79,0,100,26,15,224
ASV17928,0,0,34,40,106,21,23,224
ASV8296,0,13,19,32,71,21,67,223
ASV9186,28,17,38,31,49,22,38,223
ASV22426,21,40,70,36,18,24,14,223
ASV2018,24,26,29,29,52,37,25,222
ASV2709,0,105,13,8,0,30,66,222
ASV21414,10,11,53,72,41,23,12,222
ASV10982,40,0,66,30,48,15,22,221
ASV42,27,16,34,34,32,28,49,220
ASV3862,11,0,0,12,146,2,49,220
ASV2824,10,47,39,41,23,22,37,219
ASV3054,49,26,40,23,14,59,8,219
ASV7085,0,21,47,43,34,56,18,219
ASV16572,0,204,0,0,15,0,0,219
ASV306,9,26,42,31,31,26,53,218
ASV1812,30,34,17,31,62,21,23,218
ASV3741,6,23,47,34,22,29,57,218
ASV5251,18,29,49,10,53,30,29,218
ASV5770,0,11,56,61,17,33,40,218
ASV1862,0,24,41,39,5,75,33,217
ASV4976,5,0,39,75,53,24,21,217
ASV8279,11,0,59,0,34,112,1,217
ASV1169,0,0,12,8,6,166,24,216
ASV2907,48,11,36,14,40,36,31,216
ASV11065,0,0,157,22,0,37,0,216
ASV480,0,0,21,45,59,67,23,215
ASV1923,5,0,77,36,53,14,30,215
ASV7158,17,15,34,4,79,25,41,215
ASV12004,9,11,52,28,20,73,22,215
ASV14086,0,13,53,30,11,76,32,215
ASV135,24,23,50,20,70,1,26,214
ASV10844,3,52,26,13,4,29,87,214
ASV2763,26,36,37,35,10,60,9,213
ASV5336,0,0,32,18,121,25,17,213
ASV6619,9,20,18,40,31,38,57,213
ASV7526,0,89,8,14,21,6,75,213
ASV10045,18,61,25,39,25,0,45,213
ASV18117,5,23,35,49,58,0,43,213
ASV839,30,30,16,38,31,20,47,212
ASV1014,0,0,0,101,15,23,73,212
ASV3467,0,86,50,11,20,27,18,212
ASV3582,15,10,26,25,64,39,33,212
ASV5113,13,105,0,18,5,63,8,212
ASV10309,9,48,0,137,18,0,0,212
ASV11674,8,19,41,50,45,25,24,212
ASV12095,0,11,37,76,26,39,23,212
ASV14275,53,0,60,9,10,42,38,212
ASV19336,13,87,112,0,0,0,0,212
ASV1205,0,60,94,26,18,0,13,211
ASV1346,0,0,121,34,54,0,2,211
ASV1987,0,8,3,152,35,0,13,211
ASV10804,0,1,104,106,0,0,0,211
ASV4113,8,25,48,45,21,36,27,210
ASV7810,4,28,55,16,17,34,56,210
ASV2386,0,16,33,5,61,34,60,209
ASV5962,0,0,164,5,26,14,0,209
ASV8151,0,36,81,4,9,76,3,209
ASV9429,0,16,2,82,28,57,24,209
ASV523,58,14,18,25,37,11,45,208
ASV549,0,17,42,25,37,27,60,208
ASV847,0,0,30,15,88,67,7,207
ASV5825,0,10,37,16,37,35,72,207
ASV7391,9,21,11,78,31,21,36,207
ASV12618,0,0,147,0,0,60,0,207
ASV14126,8,9,28,28,73,3,58,207
ASV5134,15,32,8,20,103,2,26,206
ASV6489,19,31,24,19,22,47,44,206
ASV10586,0,31,16,32,61,4,62,206
ASV12265,0,8,0,29,14,0,155,206
ASV6271,13,30,14,37,80,6,25,205
ASV13866,0,1,12,27,0,145,20,205
ASV16245,4,58,139,4,0,0,0,205
ASV3178,28,17,46,22,40,9,42,204
ASV814,21,8,23,45,1,84,21,203
ASV1712,3,3,25,42,18,21,91,203
ASV4102,12,24,31,33,46,7,50,203
ASV8139,28,0,131,17,22,0,5,203
ASV9923,16,9,42,40,6,11,79,203
ASV2295,15,0,19,71,27,14,54,200
ASV2625,13,10,3,5,19,29,121,200
ASV4081,4,31,15,16,64,19,51,200
ASV14638,23,24,29,19,49,18,38,200
ASV21891,3,51,15,18,0,32,81,200
ASV3815,9,0,74,17,19,68,12,199
ASV7992,0,63,49,11,9,25,42,199
ASV12869,0,24,13,38,52,16,56,199
ASV2620,0,50,45,46,9,42,6,198
ASV6857,1,0,161,8,28,0,0,198
ASV11093,0,64,53,30,7,32,12,198
ASV671,4,0,93,16,4,47,33,197
ASV1274,3,28,64,16,15,19,52,197
ASV4663,0,2,24,44,22,77,27,196
ASV8606,12,13,84,16,49,3,19,196
ASV11078,32,10,49,65,3,16,21,196
ASV11227,18,22,41,24,58,22,11,196
ASV12861,0,68,30,37,41,0,20,196
ASV15949,2,7,16,67,19,10,75,196
ASV22084,0,0,0,0,0,0,196,196
ASV1468,11,41,43,27,30,0,43,195
ASV26574,59,0,38,55,0,33,10,195
ASV8436,24,21,40,28,2,28,51,194
ASV12277,0,19,51,21,22,50,31,194
ASV12975,0,41,10,20,76,17,30,194
ASV6029,11,34,43,16,19,41,29,193
ASV13150,0,43,24,28,33,4,61,193
ASV23332,0,31,56,34,34,6,32,193
ASV120,3,13,24,7,2,112,31,192
ASV2078,0,0,35,15,9,9,124,192
ASV2416,0,35,34,32,10,41,40,192
ASV4114,15,8,52,18,99,0,0,192
ASV4120,2,9,37,50,40,33,20,191
ASV7453,25,50,18,24,27,39,8,191
ASV11255,11,3,29,42,43,22,41,191
ASV1443,11,37,34,43,8,23,34,190
ASV2200,7,20,42,0,18,103,0,190
ASV18529,4,52,101,20,5,8,0,190
ASV12146,49,58,15,13,23,6,25,189
ASV13426,0,0,0,189,0,0,0,189
ASV339,5,15,59,23,46,19,21,188
ASV565,0,0,7,11,14,23,133,188
ASV1502,4,0,0,120,0,9,55,188
ASV5184,21,50,5,33,72,0,7,188
ASV9312,8,34,28,21,20,77,0,188
ASV693,3,10,40,82,18,12,22,187
ASV3146,12,6,41,35,26,31,36,187
ASV7285,0,31,61,0,16,47,32,187
ASV9857,0,9,39,28,29,24,58,187
ASV13395,0,10,30,7,45,31,64,187
ASV21409,0,4,20,78,17,67,1,187
ASV5832,3,0,26,45,46,28,38,186
ASV8886,21,7,35,12,23,59,29,186
ASV2499,23,15,32,44,41,30,0,185
ASV6660,5,11,19,46,79,12,13,185
ASV9129,0,15,32,41,53,9,35,185
ASV9237,0,45,37,16,18,53,16,185
ASV1442,0,18,22,19,34,44,47,184
ASV3143,0,0,0,0,0,20,164,184
ASV5458,22,27,12,19,69,14,21,184
ASV10349,0,0,101,5,59,0,19,184
ASV806,25,11,33,6,13,47,48,183
ASV5761,0,21,53,11,28,20,50,183
ASV8519,51,0,5,0,4,79,44,183
ASV11131,3,4,43,18,34,27,54,183
ASV15556,8,0,127,0,4,44,0,183
ASV18239,12,0,0,68,101,0,2,183
ASV11,0,16,30,47,31,18,40,182
ASV1656,7,25,41,40,25,20,24,182
ASV8188,15,5,12,10,15,44,81,182
ASV9649,0,0,0,0,0,182,0,182
ASV13859,7,34,27,31,32,6,45,182
ASV15569,15,13,4,9,33,62,46,182
ASV595,0,12,26,17,62,12,52,181
ASV3176,16,33,75,11,31,14,1,181
ASV4223,1,9,32,53,30,32,24,181
ASV5753,0,11,41,21,27,0,81,181
ASV7058,0,0,0,180,0,1,0,181
ASV12643,0,11,8,76,0,46,40,181
ASV13055,0,181,0,0,0,0,0,181
ASV638,32,0,31,34,19,31,33,180
ASV3507,0,10,37,40,41,47,5,180
ASV13586,4,4,129,3,22,18,0,180
ASV14637,11,0,17,29,42,15,66,180
ASV145,0,6,36,41,58,32,6,179
ASV10384,4,9,35,42,46,6,37,179
ASV11974,0,36,6,16,3,118,0,179
ASV16490,0,179,0,0,0,0,0,179
ASV1952,0,1,40,18,58,45,16,178
ASV2154,0,6,30,26,37,7,72,178
ASV2425,0,5,32,6,66,40,29,178
ASV4874,15,0,29,46,43,39,6,178
ASV6893,0,42,28,17,11,16,64,178
ASV9077,0,0,0,40,105,22,11,178
ASV15462,21,3,38,54,30,9,23,178
ASV1214,0,46,31,67,20,0,13,177
ASV1875,0,0,0,5,121,29,22,177
ASV5332,21,0,51,20,12,52,21,177
ASV5979,7,12,3,48,44,14,49,177
ASV6459,14,21,39,13,17,37,36,177
ASV7625,0,18,1,7,50,28,73,177
ASV13442,7,22,29,40,0,0,79,177
ASV13543,12,16,61,40,0,27,21,177
ASV2768,0,0,120,2,0,54,0,176
ASV7105,7,6,22,21,45,24,51,176
ASV8474,0,1,2,5,159,4,5,176
ASV19131,5,12,40,27,53,1,38,176
ASV121,44,12,38,24,29,25,3,175
ASV377,0,7,65,0,21,15,67,175
ASV3687,0,0,43,54,41,9,28,175
ASV4058,0,9,0,60,28,25,53,175
ASV4794,20,12,36,42,3,49,13,175
ASV9314,6,0,93,15,20,0,41,175
ASV12148,0,44,28,11,15,67,10,175
ASV62,3,18,25,36,28,21,43,174
ASV2292,9,4,62,26,10,54,9,174
ASV4967,6,10,35,27,34,25,37,174
ASV3540,6,12,15,62,52,0,26,173
ASV4875,0,16,29,28,31,22,47,173
ASV4930,19,13,22,35,27,27,30,173
ASV8716,43,0,28,13,45,23,21,173
ASV13291,5,19,36,21,44,33,15,173
ASV629,0,0,41,27,28,26,50,172
ASV1637,0,52,0,105,11,0,4,172
ASV2915,0,2,108,21,1,2,38,172
ASV7385,26,12,37,42,6,18,31,172
ASV15972,0,0,0,0,172,0,0,172
ASV2568,2,29,12,47,30,3,48,171
ASV2694,13,21,26,28,22,17,44,171
ASV5118,19,14,41,19,5,37,36,171
ASV12401,0,9,39,80,20,6,17,171
ASV2376,0,0,59,64,43,0,4,170
ASV5162,5,24,16,57,25,21,22,170
ASV9843,0,17,39,21,53,20,20,170
ASV11075,35,7,35,28,0,38,27,170
ASV12621,6,9,14,18,19,7,97,170
ASV14106,5,12,54,42,27,20,10,170
ASV17444,16,0,0,138,0,0,16,170
ASV8672,0,28,68,15,0,42,16,169
ASV9673,19,2,9,31,35,43,30,169
ASV10091,0,4,23,27,45,24,46,169
ASV13340,7,27,9,36,28,5,57,169
ASV3409,14,12,38,19,37,12,36,168
ASV22299,1,10,38,30,27,31,31,168
ASV24164,1,164,0,0,0,0,3,168
ASV2505,27,8,25,25,43,27,12,167
ASV3283,1,9,9,32,40,16,60,167
ASV3802,26,12,22,24,31,32,20,167
ASV3986,5,1,29,11,84,17,20,167
ASV4562,23,2,6,9,76,36,15,167
ASV11790,13,5,29,48,44,2,26,167
ASV16880,0,23,21,16,33,0,74,167
ASV453,5,9,51,37,0,40,24,166
ASV3385,9,17,37,30,27,34,12,166
ASV3465,18,20,2,24,41,3,58,166
ASV3501,12,39,4,11,13,40,47,166
ASV3885,0,96,2,0,21,47,0,166
ASV9247,0,9,25,7,22,90,13,166
ASV10049,0,9,2,0,151,0,4,166
ASV15059,16,29,5,38,13,50,15,166
ASV165,0,4,33,20,44,40,24,165
ASV1508,5,10,68,34,32,15,1,165
ASV8744,9,0,0,120,0,34,2,165
ASV15807,20,22,8,26,52,0,37,165
ASV21151,4,14,33,28,53,6,26,164
ASV902,2,19,29,30,20,20,43,163
ASV4192,0,0,88,4,71,0,0,163
ASV7030,5,27,13,40,24,15,39,163
ASV9178,0,15,1,9,9,30,99,163
ASV12026,4,11,37,42,15,25,29,163
ASV23156,19,0,87,0,57,0,0,163
ASV982,19,7,36,29,25,18,28,162
ASV1540,7,93,21,24,4,6,7,162
ASV4877,4,0,77,18,20,16,27,162
ASV7274,0,6,17,3,0,0,136,162
ASV7741,0,0,8,136,0,2,16,162
ASV10234,8,15,14,29,55,14,27,162
ASV11270,10,20,39,10,12,16,55,162
ASV13490,30,30,21,18,26,21,16,162
ASV575,0,8,41,32,31,27,22,161
ASV3764,0,36,0,0,0,108,17,161
ASV9090,0,6,29,1,17,23,85,161
ASV16557,0,4,1,19,57,18,62,161
ASV72,9,19,58,23,29,9,13,160
ASV678,0,3,44,31,48,11,23,160
ASV3060,0,0,0,23,0,55,82,160
ASV4338,18,7,35,51,26,12,11,160
ASV6558,4,20,31,8,36,32,29,160
ASV7627,3,29,16,0,6,76,30,160
ASV7809,0,5,31,2,18,35,69,160
ASV9269,159,0,0,0,0,1,0,160
ASV11096,14,11,14,52,22,18,29,160
ASV12135,7,10,67,11,6,50,9,160
ASV932,0,27,36,26,40,20,10,159
ASV7014,10,10,39,51,8,29,12,159
ASV11337,5,28,7,18,23,22,56,159
ASV17205,6,24,32,18,14,8,57,159
ASV21183,0,0,0,16,143,0,0,159
ASV23787,1,0,0,139,0,17,2,159
ASV27035,62,48,10,5,15,17,2,159
ASV2232,8,3,37,21,7,46,36,158
ASV6597,23,2,28,17,16,59,13,158
ASV8643,8,24,49,29,27,10,11,158
ASV9481,0,26,23,9,29,12,59,158
ASV15129,7,0,47,27,29,35,13,158
ASV4321,0,0,31,126,0,0,0,157
ASV4499,0,0,55,16,4,9,73,157
ASV5379,2,0,15,0,2,33,105,157
ASV10107,0,30,20,24,34,1,48,157
ASV11540,44,15,0,0,0,0,98,157
ASV14576,0,17,52,9,8,68,3,157
ASV17884,0,10,42,23,19,41,22,157
ASV762,10,10,37,0,41,9,49,156
ASV929,15,7,35,11,42,11,35,156
ASV1837,0,14,36,37,3,32,34,156
ASV2507,11,19,25,26,27,30,18,156
ASV7651,0,0,55,10,18,24,49,156
ASV8455,2,8,21,37,21,0,67,156
ASV13595,9,27,14,10,10,20,66,156
ASV1483,11,11,18,31,46,22,16,155
ASV2853,6,9,47,28,30,15,20,155
ASV5265,0,20,0,33,32,15,55,155
ASV11115,112,0,31,0,0,0,12,155
ASV19893,0,0,36,43,17,42,17,155
ASV183,0,0,15,0,6,0,133,154
ASV1802,28,13,23,26,7,40,17,154
ASV2589,0,17,2,41,43,6,45,154
ASV3204,34,21,0,5,10,81,3,154
ASV4151,0,19,18,37,29,10,41,154
ASV4849,4,31,33,12,2,4,68,154
ASV11378,0,0,20,0,0,83,51,154
ASV12513,0,0,58,41,41,0,14,154
ASV13468,0,0,55,35,11,53,0,154
ASV2219,0,153,0,0,0,0,0,153
ASV5713,15,25,37,34,23,9,10,153
ASV6961,0,16,43,32,26,24,12,153
ASV7263,17,16,33,15,22,23,27,153
ASV8598,2,2,18,27,9,24,71,153
ASV11633,15,3,27,33,32,25,18,153
ASV14064,32,23,18,13,28,14,25,153
ASV18796,0,0,4,20,0,127,2,153
ASV20643,16,3,8,13,10,61,42,153
ASV20698,0,41,33,0,0,26,53,153
ASV701,7,10,42,19,15,32,27,152
ASV1623,42,0,20,35,35,12,8,152
ASV2028,0,9,20,30,29,34,30,152
ASV9012,8,19,60,22,4,16,23,152
ASV21895,0,0,0,2,0,0,150,152
ASV1505,7,0,3,84,12,44,1,151
ASV2937,4,31,14,17,43,16,26,151
ASV4528,4,3,22,32,29,54,7,151
ASV9232,1,23,35,20,23,19,30,151
ASV9973,15,0,56,23,12,20,25,151
ASV365,17,2,42,33,13,34,9,150
ASV881,0,12,29,64,0,41,4,150
ASV1477,0,5,19,35,30,24,37,150
ASV5529,0,4,44,20,12,18,52,150
ASV6519,15,6,24,23,56,2,24,150
ASV6786,0,7,51,5,12,10,65,150
ASV6909,1,4,30,32,57,15,11,150
ASV7413,24,24,22,27,27,16,10,150
ASV8362,0,25,13,28,63,10,11,150
ASV9985,5,26,30,25,25,17,22,150
ASV16101,12,13,48,11,8,11,47,150
ASV2223,0,26,26,9,49,21,18,149
ASV5969,0,5,42,52,25,4,21,149
ASV6179,3,12,21,32,27,2,52,149
ASV9409,0,4,6,87,18,26,8,149
ASV11301,0,58,5,20,8,0,58,149
ASV11332,0,15,0,100,14,0,20,149
ASV11488,5,17,34,25,28,9,31,149
ASV12930,8,4,16,12,20,0,89,149
ASV14653,16,50,11,5,8,41,18,149
ASV6159,0,8,8,21,41,11,59,148
ASV6653,142,2,1,3,0,0,0,148
ASV14628,7,25,67,14,20,13,2,148
ASV4616,13,7,21,27,27,28,24,147
ASV8599,17,34,37,27,10,11,11,147
ASV10231,0,44,54,0,10,0,39,147
ASV14847,0,15,39,77,3,8,5,147
ASV25729,0,0,0,147,0,0,0,147
ASV2072,0,0,0,0,0,0,146,146
ASV5142,13,8,0,14,18,0,93,146
ASV18714,0,126,0,9,0,0,11,146
ASV174,0,10,28,3,66,0,38,145
ASV2598,10,7,85,8,8,0,27,145
ASV3107,0,14,10,24,44,7,46,145
ASV4357,4,69,18,12,21,21,0,145
ASV6258,0,2,12,0,13,0,118,145
ASV22449,0,0,125,0,0,17,3,145
ASV23728,0,7,39,13,38,47,1,145
ASV7343,15,15,52,21,0,36,5,144
ASV7469,0,0,51,0,0,93,0,144
ASV8950,8,36,6,5,57,8,24,144
ASV9449,21,0,2,3,38,0,80,144
ASV10590,3,8,39,15,56,0,23,144
ASV10922,0,0,72,0,38,22,12,144
ASV13246,11,7,2,16,17,21,70,144
ASV555,0,26,37,14,20,6,40,143
ASV561,0,23,26,52,14,15,13,143
ASV915,10,12,41,15,21,18,26,143
ASV1177,20,0,18,9,24,27,45,143
ASV3671,11,5,54,34,12,21,6,143
ASV8326,33,0,24,30,50,0,6,143
ASV12428,0,87,3,0,0,53,0,143
ASV13623,0,5,23,103,0,12,0,143
ASV14295,5,3,32,12,29,36,26,143
ASV1518,8,2,23,54,29,9,17,142
ASV4700,4,22,42,24,10,35,5,142
ASV5391,0,26,4,0,0,44,68,142
ASV7377,4,9,29,24,18,36,22,142
ASV12882,0,0,20,0,9,113,0,142
ASV15545,0,0,0,142,0,0,0,142
ASV15936,6,26,38,18,36,9,9,142
ASV1882,23,0,0,35,0,11,72,141
ASV2493,0,23,12,19,56,6,25,141
ASV3488,29,5,37,0,16,22,32,141
ASV9405,0,6,23,24,19,4,65,141
ASV17074,0,20,29,38,32,0,22,141
ASV544,3,0,75,39,8,7,8,140
ASV550,21,7,28,31,29,6,18,140
ASV4096,0,24,29,4,25,39,19,140
ASV5358,27,33,1,26,15,25,13,140
ASV5872,5,14,15,31,42,10,23,140
ASV5881,4,12,22,9,26,39,28,140
ASV403,8,15,15,14,83,0,4,139
ASV5089,7,14,36,26,33,15,8,139
ASV5179,7,3,26,35,36,0,32,139
ASV6413,4,26,34,6,25,12,32,139
ASV6676,0,18,26,42,16,32,5,139
ASV2993,11,7,28,20,35,12,25,138
ASV3314,0,6,7,10,7,0,108,138
ASV4001,39,0,17,21,24,22,15,138
ASV7892,33,2,36,22,23,0,22,138
ASV10331,0,0,0,116,6,0,16,138
ASV10679,3,116,2,9,0,8,0,138
ASV7163,0,0,0,0,10,77,50,137
ASV7411,0,49,0,1,7,0,80,137
ASV13384,10,18,19,26,53,8,3,137
ASV17086,8,18,6,23,18,35,29,137
ASV1992,0,0,39,65,18,14,0,136
ASV2083,0,12,27,39,15,28,15,136
ASV5193,8,26,14,32,11,22,23,136
ASV14318,0,0,0,33,0,103,0,136
ASV14983,0,115,0,21,0,0,0,136
ASV22193,2,9,38,26,24,13,24,136
ASV1902,0,18,10,10,17,14,66,135
ASV2665,5,2,28,6,12,44,38,135
ASV4709,4,41,36,29,13,12,0,135
ASV11111,0,0,0,135,0,0,0,135
ASV14212,2,1,24,39,15,11,43,135
ASV17693,0,0,33,38,45,12,7,135
ASV2248,0,11,0,7,50,6,60,134
ASV4564,20,0,16,16,36,12,34,134
ASV10850,0,16,40,14,11,35,18,134
ASV12168,0,26,12,0,0,42,54,134
ASV12845,16,13,22,21,22,7,33,134
ASV13343,0,12,8,91,9,3,11,134
ASV20680,3,9,13,23,44,30,12,134
ASV1197,3,12,29,21,15,42,11,133
ASV4227,9,13,13,50,10,7,31,133
ASV4515,3,6,34,32,28,23,7,133
ASV4702,4,18,16,24,48,9,14,133
ASV4826,0,0,2,123,0,8,0,133
ASV5804,0,14,37,12,40,30,0,133
ASV10363,23,1,20,14,39,14,22,133
ASV11294,13,11,4,5,0,81,19,133
ASV13715,0,0,0,0,4,0,129,133
ASV16323,0,14,22,29,0,38,30,133
ASV17542,0,13,39,14,32,29,6,133
ASV19054,9,6,0,7,37,45,29,133
ASV19805,6,17,34,8,10,25,33,133
ASV20991,12,36,27,12,2,11,33,133
ASV1891,15,24,22,25,0,39,7,132
ASV10727,2,6,24,25,32,11,32,132
ASV14671,0,0,30,5,12,46,39,132
ASV16275,0,0,0,21,91,5,15,132
ASV1180,0,12,33,33,28,10,15,131
ASV1296,0,3,18,5,26,26,53,131
ASV3034,0,20,35,49,5,18,4,131
ASV4955,1,25,17,33,8,35,12,131
ASV8319,0,0,1,7,118,0,5,131
ASV10042,0,0,34,19,21,21,36,131
ASV10695,12,9,22,5,4,31,48,131
ASV15473,0,6,120,0,0,0,5,131
ASV20400,43,6,29,9,1,22,21,131
ASV547,14,26,0,19,39,0,32,130
ASV979,5,8,16,13,19,54,15,130
ASV1103,0,0,41,15,15,18,41,130
ASV3363,19,21,8,38,13,3,28,130
ASV3581,6,20,24,18,12,12,38,130
ASV3893,16,20,11,23,11,41,8,130
ASV4055,0,2,10,39,33,0,46,130
ASV4852,0,9,46,33,15,16,11,130
ASV6790,0,0,50,17,13,37,13,130
ASV7008,3,5,24,29,26,13,30,130
ASV9549,1,4,18,40,24,13,30,130
ASV9706,46,1,5,18,0,2,58,130
ASV10699,12,13,18,11,7,31,38,130
ASV14549,1,8,3,30,13,39,36,130
ASV14845,0,13,24,0,6,87,0,130
ASV1189,1,0,0,0,0,128,0,129
ASV1932,4,15,11,30,39,12,18,129
ASV12855,6,22,24,15,26,19,17,129
ASV19353,8,14,34,14,12,15,32,129
ASV1527,26,8,0,7,10,0,77,128
ASV3611,0,23,0,8,44,0,53,128
ASV3620,8,6,38,18,29,5,24,128
ASV3796,0,49,13,2,32,11,21,128
ASV7899,10,17,21,18,48,5,9,128
ASV8850,0,0,8,8,21,91,0,128
ASV10008,4,27,15,29,6,13,34,128
ASV11257,0,0,0,46,0,0,82,128
ASV14586,0,1,96,18,13,0,0,128
ASV669,1,11,19,48,7,8,33,127
ASV676,0,3,9,5,0,31,79,127
ASV1354,1,15,35,14,27,17,18,127
ASV5623,0,15,28,8,23,21,32,127
ASV15914,0,18,4,12,29,18,46,127
ASV2650,0,27,20,29,21,9,20,126
ASV3402,1,122,0,0,0,3,0,126
ASV6237,0,0,24,27,18,31,26,126
ASV6508,0,16,18,19,20,34,19,126
ASV8300,3,0,19,9,35,14,46,126
ASV9937,16,6,6,14,61,7,16,126
ASV11127,0,24,1,43,9,9,40,126
ASV14946,23,10,31,42,0,20,0,126
ASV823,38,0,0,0,15,35,37,125
ASV2127,2,3,41,21,25,3,30,125
ASV4614,13,3,36,13,32,23,5,125
ASV10990,0,14,18,34,7,18,34,125
ASV12657,7,8,28,10,30,21,21,125
ASV16131,0,0,0,0,0,5,120,125
ASV22654,0,35,8,53,0,0,29,125
ASV432,0,1,27,42,25,9,20,124
ASV705,47,7,0,11,24,27,8,124
ASV3464,8,15,7,33,15,2,44,124
ASV4425,5,15,16,31,22,24,11,124
ASV4957,0,22,15,45,0,38,4,124
ASV4958,0,95,29,0,0,0,0,124
ASV5628,1,20,34,18,5,10,36,124
ASV16106,0,5,12,13,22,2,70,124
ASV16283,15,13,9,22,26,10,29,124
ASV20177,0,66,38,17,1,0,2,124
ASV22770,6,5,30,21,18,7,37,124
ASV254,3,10,16,21,26,29,18,123
ASV1009,0,0,0,0,123,0,0,123
ASV1302,12,10,22,13,22,35,9,123
ASV3332,82,5,0,31,4,0,1,123
ASV4161,0,0,0,0,117,6,0,123
ASV5930,0,5,0,27,56,0,35,123
ASV6767,0,3,31,5,6,50,28,123
ASV7501,0,10,33,34,9,31,6,123
ASV7525,2,12,39,11,11,22,26,123
ASV10076,46,0,0,64,0,0,13,123
ASV12718,4,22,16,26,12,4,39,123
ASV14022,21,7,15,5,22,52,1,123
ASV16605,6,12,28,26,10,15,26,123
ASV1362,0,0,77,0,23,0,22,122
ASV4270,0,4,3,8,40,6,61,122
ASV7464,0,17,35,24,18,18,10,122
ASV9274,0,0,30,40,19,5,28,122
ASV10031,0,0,0,9,55,19,39,122
ASV11020,0,0,5,51,16,39,11,122
ASV14642,0,0,0,0,0,122,0,122
ASV1643,24,30,19,9,8,10,21,121
ASV8846,17,0,3,31,0,0,70,121
ASV8859,0,3,17,12,22,24,43,121
ASV12352,0,13,32,30,20,0,26,121
ASV13255,2,15,23,2,19,37,23,121
ASV17414,3,109,1,0,0,4,4,121
ASV1745,0,0,0,0,0,4,116,120
ASV3775,3,35,27,12,2,24,17,120
ASV4401,0,15,18,40,31,1,15,120
ASV4568,0,12,4,14,51,13,26,120
ASV4718,0,5,48,4,27,5,31,120
ASV5727,4,5,30,21,7,37,16,120
ASV9512,0,19,48,2,3,44,4,120
ASV12391,72,0,30,6,10,0,2,120
ASV20541,0,9,32,16,19,22,22,120
ASV406,0,11,19,22,2,23,42,119
ASV8364,13,6,13,22,9,15,41,119
ASV9668,66,50,3,0,0,0,0,119
ASV17955,6,40,13,4,0,26,30,119
ASV23716,0,20,4,3,53,39,0,119
ASV25651,3,11,18,33,14,5,35,119
ASV1256,0,26,0,0,0,92,0,118
ASV1560,10,23,14,19,20,15,17,118
ASV1596,0,7,8,0,48,36,19,118
ASV2908,0,0,41,3,42,16,16,118
ASV3113,0,3,32,3,47,25,8,118
ASV5041,0,31,19,2,26,38,2,118
ASV5578,9,37,69,1,2,0,0,118
ASV5584,0,51,0,13,0,50,4,118
ASV6813,0,27,30,15,6,21,19,118
ASV7492,0,0,18,35,39,26,0,118
ASV8042,0,16,36,14,28,10,14,118
ASV8144,0,0,0,113,0,5,0,118
ASV9564,5,4,26,14,10,53,6,118
ASV10129,0,13,23,18,18,30,16,118
ASV22290,29,32,3,25,20,0,9,118
ASV1519,0,0,40,22,41,4,10,117
ASV2732,6,19,7,21,36,6,22,117
ASV3982,6,7,6,28,15,32,23,117
ASV4766,7,20,15,9,13,38,15,117
ASV5590,19,15,37,5,7,18,16,117
ASV9494,12,33,7,36,0,23,6,117
ASV9914,2,19,10,5,34,14,33,117
ASV12450,0,0,7,94,6,0,10,117
ASV17569,15,6,20,11,41,15,9,117
ASV23932,0,0,117,0,0,0,0,117
ASV26,0,0,0,116,0,0,0,116
ASV2671,13,8,42,0,45,8,0,116
ASV2726,8,20,31,11,0,35,11,116
ASV4259,1,14,31,0,35,16,19,116
ASV4269,8,32,36,16,2,14,8,116
ASV4274,10,7,36,10,33,2,18,116
ASV4500,12,24,20,19,38,0,3,116
ASV4816,2,22,11,9,49,10,13,116
ASV8270,0,23,80,0,0,10,3,116
ASV10760,15,2,20,4,16,38,21,116
ASV12482,0,26,66,2,22,0,0,116
ASV1780,0,3,27,25,12,32,16,115
ASV4781,0,16,32,17,1,1,48,115
ASV6773,0,4,0,15,28,63,5,115
ASV6822,18,35,24,19,13,2,4,115
ASV6840,0,0,0,115,0,0,0,115
ASV7168,0,24,2,3,35,36,15,115
ASV11616,9,8,29,21,7,9,32,115
ASV15669,66,0,0,18,7,12,12,115
ASV18382,3,4,25,15,16,0,52,115
ASV20009,0,14,25,0,8,3,65,115
ASV24446,2,18,37,17,5,24,12,115
ASV1903,0,0,19,4,86,0,5,114
ASV5983,0,7,15,4,3,44,41,114
ASV6975,4,10,13,10,15,21,41,114
ASV7390,0,5,20,37,27,23,2,114
ASV8916,0,0,40,0,19,55,0,114
ASV9225,3,37,0,0,20,54,0,114
ASV10047,8,16,14,43,20,0,13,114
ASV12864,3,5,0,3,0,103,0,114
ASV17650,14,1,21,30,23,15,10,114
ASV20551,0,35,0,0,0,0,79,114
ASV619,5,0,60,42,1,0,5,113
ASV2112,0,19,13,8,15,20,38,113
ASV4741,0,12,7,8,15,11,60,113
ASV4843,0,32,4,2,0,0,75,113
ASV12732,2,10,17,40,15,7,22,113
ASV15150,8,0,0,0,72,0,33,113
ASV16007,4,11,26,18,10,30,14,113
ASV19291,82,2,0,0,13,13,3,113
ASV19673,108,5,0,0,0,0,0,113
ASV22331,45,15,0,1,0,48,4,113
ASV3445,0,11,81,0,0,20,0,112
ASV4414,14,16,6,32,25,17,2,112
ASV4854,0,13,3,8,29,4,55,112
ASV5153,27,19,14,20,14,10,8,112
ASV11681,110,0,2,0,0,0,0,112
ASV12642,0,9,40,7,24,22,10,112
ASV15736,33,25,0,11,29,14,0,112
ASV15890,14,0,14,64,5,10,5,112
ASV20338,0,4,0,14,1,10,83,112
ASV26519,0,11,4,3,37,16,41,112
ASV3164,0,2,15,10,22,57,5,111
ASV5456,0,21,43,27,4,0,16,111
ASV5555,0,5,30,7,20,20,29,111
ASV24016,5,7,0,39,20,18,22,111
ASV2512,1,19,10,28,27,3,22,110
ASV2528,10,12,17,27,6,23,15,110
ASV3041,3,17,20,7,7,18,38,110
ASV3325,0,82,0,24,0,0,4,110
ASV6435,0,24,0,0,9,53,24,110
ASV7121,3,11,24,59,8,0,5,110
ASV10171,13,25,2,22,11,22,15,110
ASV11885,0,0,0,82,23,0,5,110
ASV13397,0,23,48,20,0,0,19,110
ASV14232,0,0,9,9,18,60,14,110
ASV18478,0,0,11,21,30,33,15,110
ASV443,9,0,44,9,15,31,1,109
ASV3214,47,0,20,4,14,14,10,109
ASV6097,0,13,7,20,14,23,32,109
ASV6574,2,7,16,22,37,3,22,109
ASV6602,0,0,98,0,0,11,0,109
ASV11269,2,7,9,7,49,5,30,109
ASV14466,0,0,0,109,0,0,0,109
ASV2355,0,15,18,1,33,32,9,108
ASV2812,31,12,0,36,12,8,9,108
ASV4137,14,0,0,39,39,14,2,108
ASV4354,11,19,16,25,3,19,15,108
ASV4636,0,7,15,14,39,2,31,108
ASV5068,21,10,12,7,13,15,30,108
ASV5580,9,5,37,9,27,10,11,108
ASV7031,0,3,17,31,6,27,24,108
ASV7447,0,2,17,45,8,16,20,108
ASV9103,17,6,54,9,6,4,12,108
ASV10369,0,9,31,5,0,12,51,108
ASV12234,2,13,17,33,19,6,18,108
ASV13657,1,4,24,38,16,2,23,108
ASV15658,0,0,16,20,32,29,11,108
ASV16166,1,1,12,3,69,9,13,108
ASV16485,3,19,42,10,25,1,8,108
ASV20001,0,15,31,18,16,8,20,108
ASV841,29,6,31,10,14,3,14,107
ASV2150,10,43,0,20,18,13,3,107
ASV5533,38,0,43,5,6,0,15,107
ASV6161,29,13,8,14,21,0,22,107
ASV7999,12,15,18,21,23,5,13,107
ASV8423,2,20,32,13,7,4,29,107
ASV15867,0,0,39,0,19,0,49,107
ASV20495,0,1,20,16,42,26,2,107
ASV1365,0,21,7,31,13,5,29,106
ASV2634,18,12,23,19,17,7,10,106
ASV6334,5,8,8,37,36,6,6,106
ASV7368,0,9,25,32,7,7,26,106
ASV7707,0,7,7,49,2,0,41,106
ASV8795,0,7,14,36,7,12,30,106
ASV9038,11,10,53,9,1,21,1,106
ASV10158,26,5,12,15,20,14,14,106
ASV13833,6,16,13,19,14,14,24,106
ASV18791,0,21,34,5,2,44,0,106
ASV21771,15,9,17,28,30,2,5,106
ASV24476,0,0,0,0,7,99,0,106
ASV24886,0,2,5,0,2,84,13,106
ASV2417,0,30,27,3,4,32,9,105
ASV6942,17,0,23,10,29,14,12,105
ASV7179,12,1,14,8,15,41,14,105
ASV8224,0,0,13,13,59,8,12,105
ASV10166,0,1,40,37,14,5,8,105
ASV11187,0,0,1,0,0,104,0,105
ASV13602,2,28,8,14,7,0,46,105
ASV20504,0,0,93,0,0,12,0,105
ASV21973,8,0,0,1,53,0,43,105
ASV1463,0,0,28,11,40,17,8,104
ASV2975,0,2,18,10,20,11,43,104
ASV3334,0,16,12,19,20,16,21,104
ASV4520,0,0,0,0,26,0,78,104
ASV5730,0,0,39,18,8,0,39,104
ASV6671,0,0,24,14,0,0,66,104
ASV7017,31,29,6,4,20,0,14,104
ASV7190,1,0,12,2,22,49,18,104
ASV8530,13,0,18,16,13,21,23,104
ASV9767,13,0,9,7,26,5,44,104
ASV10784,0,0,89,0,12,3,0,104
ASV10842,0,0,45,27,0,32,0,104
ASV24223,0,9,8,3,14,13,57,104
ASV97,5,0,0,14,17,2,65,103
ASV687,2,0,15,10,32,44,0,103
ASV953,0,27,8,20,9,17,22,103
ASV1319,12,22,11,8,9,26,15,103
ASV3182,0,20,2,43,13,15,10,103
ASV5416,0,13,4,20,37,8,21,103
ASV7175,0,0,18,34,3,10,38,103
ASV7963,0,2,49,23,11,18,0,103
ASV7983,0,0,38,0,3,62,0,103
ASV8207,0,0,32,0,11,44,16,103
ASV8324,2,0,71,8,0,0,22,103
ASV8441,3,6,0,15,7,29,43,103
ASV9601,4,0,11,25,34,24,5,103
ASV10185,0,24,70,0,0,0,9,103
ASV12174,0,18,27,22,2,9,25,103
ASV14379,0,43,2,3,6,45,4,103
ASV19283,0,0,0,103,0,0,0,103
ASV22404,6,11,14,12,18,10,32,103
ASV1738,30,0,8,11,26,5,22,102
ASV2070,0,0,4,37,0,18,43,102
ASV2282,74,0,4,0,0,23,1,102
ASV2340,0,5,21,8,17,40,11,102
ASV3333,0,0,31,0,2,10,59,102
ASV5951,10,7,8,32,10,23,12,102
ASV7188,0,0,5,6,37,19,35,102
ASV7457,4,0,13,31,27,16,11,102
ASV10111,2,10,18,25,16,5,26,102
ASV12019,0,6,0,0,9,87,0,102
ASV13577,0,13,2,0,57,0,30,102
ASV14648,0,21,9,9,0,59,4,102
ASV20106,0,2,3,41,22,12,22,102
ASV578,2,5,25,26,24,2,17,101
ASV895,0,0,50,12,3,36,0,101
ASV1330,0,6,46,10,15,14,10,101
ASV2285,0,0,16,41,18,16,10,101
ASV2653,8,8,44,33,8,0,0,101
ASV5067,2,10,25,16,19,14,15,101
ASV5069,0,14,0,7,29,7,44,101
ASV5318,10,8,20,13,13,7,30,101
ASV10162,7,10,35,13,24,0,12,101
ASV10868,0,20,8,64,0,0,9,101
ASV10972,0,0,10,14,21,0,56,101
ASV11859,2,9,17,11,31,10,21,101
ASV12086,0,2,14,26,32,4,23,101
ASV12834,0,0,10,9,28,7,47,101
ASV13306,0,8,25,13,19,10,26,101
ASV14358,1,50,5,29,0,0,16,101
ASV18209,0,0,12,41,33,14,1,101
ASV23698,0,0,99,0,0,0,2,101
ASV2739,4,5,44,7,2,18,20,100
ASV2854,5,45,8,14,9,6,13,100
ASV5084,7,12,5,17,6,0,53,100
ASV5542,0,55,0,0,22,8,15,100
ASV5567,5,5,26,12,16,10,26,100
ASV6117,8,18,12,3,25,8,26,100
ASV7743,5,2,18,29,19,18,9,100
ASV8164,6,5,27,38,2,3,19,100
ASV9443,0,0,24,5,0,41,30,100
ASV10643,0,9,21,26,20,11,13,100
ASV10752,0,1,25,35,22,7,10,100
ASV12235,0,13,21,10,24,7,25,100
ASV18857,0,2,28,19,29,18,4,100
ASV23731,0,27,21,3,22,16,11,100
ASV26614,0,42,31,2,0,25,0,100
ASV1912,0,49,0,8,42,0,0,99
ASV4792,0,5,13,65,6,10,0,99
ASV7649,0,3,29,19,6,10,32,99
ASV8385,0,5,7,3,82,0,2,99
ASV10504,14,16,29,14,25,0,1,99
ASV11140,9,4,20,1,27,0,38,99
ASV11478,5,30,3,6,21,1,33,99
ASV14846,0,3,4,0,14,52,26,99
ASV16814,0,99,0,0,0,0,0,99
ASV20037,0,0,15,60,17,7,0,99
ASV24477,9,6,20,46,4,6,8,99
ASV675,25,2,12,0,7,11,41,98
ASV2043,12,6,4,10,35,0,31,98
ASV3035,6,1,0,7,84,0,0,98
ASV3738,2,53,0,33,0,0,10,98
ASV4623,5,7,0,24,43,0,19,98
ASV5649,0,0,70,22,0,0,6,98
ASV6951,7,13,8,30,14,14,12,98
ASV7182,0,7,47,10,6,7,21,98
ASV7419,0,5,33,4,9,12,35,98
ASV10587,0,10,23,8,18,2,37,98
ASV10851,0,4,52,0,6,33,3,98
ASV11520,4,11,28,12,4,5,34,98
ASV12060,18,1,13,12,28,15,11,98
ASV12218,0,0,10,12,4,3,69,98
ASV12794,35,22,11,14,1,15,0,98
ASV14660,54,30,0,14,0,0,0,98
ASV19198,11,12,25,6,1,9,34,98
ASV20779,0,0,1,0,0,95,2,98
ASV7,5,0,8,22,0,38,24,97
ASV1051,5,37,10,3,5,25,12,97
ASV1584,1,5,23,24,29,11,4,97
ASV1654,0,0,28,1,0,6,62,97
ASV1693,5,5,8,6,0,44,29,97
ASV5343,0,3,0,91,0,3,0,97
ASV12593,0,1,12,8,21,44,11,97
ASV12815,0,36,41,8,0,0,12,97
ASV12842,1,0,31,23,3,9,30,97
ASV15739,0,8,6,7,54,3,19,97
ASV20851,7,12,7,0,40,19,12,97
ASV584,0,5,0,0,13,0,78,96
ASV2100,2,25,17,9,6,19,18,96
ASV4536,11,0,9,40,20,0,16,96
ASV5290,0,5,15,3,1,72,0,96
ASV5845,0,0,21,19,13,5,38,96
ASV6924,10,22,19,10,0,24,11,96
ASV10139,0,0,16,7,3,11,59,96
ASV13210,0,0,0,96,0,0,0,96
ASV14376,0,0,35,0,30,19,12,96
ASV17870,4,20,8,7,25,11,21,96
ASV25396,0,0,96,0,0,0,0,96
ASV1007,6,6,14,22,4,15,28,95
ASV1238,0,10,21,22,9,33,0,95
ASV1336,0,11,9,28,24,14,9,95
ASV2259,0,2,42,29,3,0,19,95
ASV2608,0,0,0,0,95,0,0,95
ASV5558,1,5,21,10,20,33,5,95
ASV7944,0,0,42,8,5,19,21,95
ASV9513,5,3,26,0,25,2,34,95
ASV9562,0,0,0,0,21,0,74,95
ASV9840,16,5,24,18,10,1,21,95
ASV11388,7,9,16,15,26,0,22,95
ASV12079,35,15,9,9,10,5,12,95
ASV12319,0,18,17,0,0,0,60,95
ASV12827,0,0,32,13,4,27,19,95
ASV13634,0,0,19,10,32,21,13,95
ASV13821,0,0,29,6,6,13,41,95
ASV14797,0,0,52,0,0,33,10,95
ASV16755,7,7,0,31,15,0,35,95
ASV17030,0,3,56,0,4,32,0,95
ASV19032,17,0,0,44,34,0,0,95
ASV607,9,6,28,7,14,4,26,94
ASV2009,5,18,0,26,23,7,15,94
ASV2746,1,52,0,35,0,0,6,94
ASV3246,8,22,17,21,4,22,0,94
ASV5185,4,3,12,23,27,1,24,94
ASV8495,0,21,12,4,35,5,17,94
ASV9099,0,17,24,10,2,21,20,94
ASV9118,0,0,2,88,0,1,3,94
ASV11872,0,6,22,16,15,3,32,94
ASV12114,0,0,3,0,91,0,0,94
ASV12826,14,0,13,24,30,9,4,94
ASV15562,2,20,4,60,3,0,5,94
ASV17780,0,4,24,16,16,12,22,94
ASV20757,7,13,44,1,3,23,3,94
ASV25785,0,0,23,0,7,39,25,94
ASV228,39,12,3,21,10,3,5,93
ASV1012,0,4,37,5,20,8,19,93
ASV2257,5,8,14,34,19,6,7,93
ASV2667,18,23,11,5,9,10,17,93
ASV2810,0,5,14,48,5,19,2,93
ASV6062,0,4,26,4,29,28,2,93
ASV7382,7,5,28,20,2,6,25,93
ASV10192,10,14,2,14,4,3,46,93
ASV10254,0,0,0,28,30,4,31,93
ASV10318,11,51,3,4,0,6,18,93
ASV10344,0,7,43,1,7,31,4,93
ASV10364,15,7,16,12,22,2,19,93
ASV11817,2,0,35,0,8,0,48,93
ASV16001,32,4,30,17,5,1,4,93
ASV19916,0,0,46,0,39,0,8,93
ASV22258,15,8,21,25,21,3,0,93
ASV1418,6,8,25,9,14,9,21,92
ASV3194,0,11,12,8,5,33,23,92
ASV5115,0,13,10,13,21,8,27,92
ASV10257,0,2,23,40,13,8,6,92
ASV10509,0,3,18,16,2,44,9,92
ASV12324,7,7,22,14,12,0,30,92
ASV12782,7,12,22,0,18,27,6,92
ASV17405,3,10,12,12,16,28,11,92
ASV26329,0,8,0,4,80,0,0,92
ASV539,5,12,20,9,26,12,7,91
ASV2660,6,18,24,19,15,9,0,91
ASV3403,0,3,55,7,0,26,0,91
ASV3984,0,13,32,15,14,14,3,91
ASV4387,0,4,21,27,16,3,20,91
ASV4482,0,0,17,11,18,4,41,91
ASV4483,0,0,0,91,0,0,0,91
ASV7737,0,7,32,0,19,12,21,91
ASV7772,0,1,16,12,8,18,36,91
ASV8153,7,6,12,12,24,2,28,91
ASV8244,0,0,2,7,53,11,18,91
ASV14141,13,11,24,0,7,27,9,91
ASV15384,4,5,48,0,3,31,0,91
ASV18390,0,25,7,0,1,47,11,91
ASV19657,0,69,0,17,0,0,5,91
ASV22424,0,4,48,39,0,0,0,91
ASV2191,0,0,14,0,12,0,64,90
ASV2378,4,16,29,5,9,12,15,90
ASV2862,7,7,30,32,1,10,3,90
ASV3954,0,21,15,10,23,21,0,90
ASV5244,0,3,19,5,15,11,37,90
ASV5481,16,0,21,11,9,22,11,90
ASV6674,0,14,36,0,21,11,8,90
ASV6684,0,8,67,0,0,15,0,90
ASV10428,0,6,0,36,22,0,26,90
ASV11097,4,10,8,22,11,0,35,90
ASV13301,8,0,19,33,0,25,5,90
ASV15305,0,3,41,23,23,0,0,90
ASV25600,0,51,14,4,0,21,0,90
ASV175,5,15,9,19,14,14,13,89
ASV1669,0,0,20,11,5,21,32,89
ASV2114,0,13,31,40,3,2,0,89
ASV2443,0,7,4,11,47,6,14,89
ASV2461,0,31,23,0,4,0,31,89
ASV2483,0,15,37,8,8,8,13,89
ASV3553,22,7,11,7,25,17,0,89
ASV3585,22,7,6,27,2,13,12,89
ASV5601,0,0,67,0,0,22,0,89
ASV6476,6,0,7,24,17,12,23,89
ASV6922,0,9,6,7,11,21,35,89
ASV13137,0,0,0,5,5,16,63,89
ASV13206,0,1,47,11,26,0,4,89
ASV20405,73,0,7,0,0,0,9,89
ASV742,0,7,40,3,23,6,9,88
ASV1723,0,8,8,5,31,18,18,88
ASV1809,22,4,18,10,19,0,15,88
ASV2033,36,0,4,12,16,8,12,88
ASV2221,0,30,19,7,3,16,13,88
ASV2439,0,7,9,2,24,34,12,88
ASV2774,8,4,4,9,15,8,40,88
ASV4060,5,0,31,8,15,15,14,88
ASV4156,0,0,8,16,31,6,27,88
ASV6133,0,7,19,2,35,7,18,88
ASV6907,10,2,14,17,15,18,12,88
ASV6948,0,0,11,32,16,26,3,88
ASV11753,9,0,41,14,3,16,5,88
ASV15284,0,12,18,12,7,5,34,88
ASV16752,10,5,25,4,15,0,29,88
ASV23704,0,0,12,15,31,21,9,88
ASV24387,14,9,3,22,27,6,7,88
ASV2467,16,25,42,1,1,2,0,87
ASV3098,9,12,18,9,22,10,7,87
ASV3533,0,0,10,29,48,0,0,87
ASV4135,1,3,30,10,13,12,18,87
ASV5039,11,3,9,24,23,10,7,87
ASV7127,3,14,4,9,9,17,31,87
ASV7395,8,14,16,13,10,14,12,87
ASV9293,5,0,34,14,0,30,4,87
ASV9676,12,0,6,18,29,0,22,87
ASV9903,1,1,9,7,26,43,0,87
ASV14793,0,12,15,19,7,9,25,87
ASV16108,0,0,16,67,0,0,4,87
ASV154,4,14,14,6,24,0,24,86
ASV529,7,0,7,59,4,9,0,86
ASV795,0,0,0,0,65,0,21,86
ASV2118,5,12,13,0,33,21,2,86
ASV2387,11,0,10,36,9,15,5,86
ASV2570,0,8,24,12,0,12,30,86
ASV5535,37,26,13,9,0,0,1,86
ASV13702,10,6,12,16,23,9,10,86
ASV13950,0,5,22,7,23,24,5,86
ASV14066,35,0,10,13,19,1,8,86
ASV14073,0,9,7,22,11,24,13,86
ASV14357,0,10,0,45,6,25,0,86
ASV15486,0,4,8,17,0,32,25,86
ASV15537,3,10,34,16,15,5,3,86
ASV18449,0,1,26,23,16,5,15,86
ASV1289,0,8,26,2,7,35,7,85
ASV2560,0,3,2,11,26,7,36,85
ASV3565,19,9,32,17,0,0,8,85
ASV3625,0,29,3,8,6,0,39,85
ASV4076,3,0,1,10,0,0,71,85
ASV5492,1,6,28,14,25,1,10,85
ASV5680,82,0,0,0,0,1,2,85
ASV5937,5,6,24,12,1,22,15,85
ASV6686,0,3,54,13,0,0,15,85
ASV7032,0,6,14,12,8,35,10,85
ASV7330,0,9,29,4,17,8,18,85
ASV7611,0,43,0,24,18,0,0,85
ASV8869,2,4,25,25,19,0,10,85
ASV11181,14,3,29,1,32,6,0,85
ASV12955,0,9,22,24,10,10,10,85
ASV14889,49,20,0,0,10,2,4,85
ASV16110,0,8,48,0,9,16,4,85
ASV18806,0,17,21,9,15,8,15,85
ASV18955,0,4,15,21,20,7,18,85
ASV849,0,17,0,67,0,0,0,84
ASV9651,12,14,5,17,22,4,10,84
ASV12281,0,0,0,54,0,0,30,84
ASV14871,18,10,8,19,7,3,19,84
ASV16417,0,10,0,10,48,0,16,84
ASV17268,14,37,21,0,0,0,12,84
ASV18124,0,0,4,0,80,0,0,84
ASV19193,17,2,29,12,0,19,5,84
ASV19706,0,0,21,29,2,11,21,84
ASV23580,84,0,0,0,0,0,0,84
ASV24449,0,0,28,1,16,33,6,84
ASV243,0,0,14,3,62,0,4,83
ASV993,4,13,0,12,0,24,30,83
ASV1416,0,0,6,4,6,51,16,83
ASV1813,22,0,11,2,20,28,0,83
ASV2459,32,3,14,5,0,17,12,83
ASV4129,0,5,0,4,29,6,39,83
ASV4355,0,0,0,6,4,0,73,83
ASV4407,0,4,7,17,38,2,15,83
ASV4480,3,6,0,7,38,13,16,83
ASV5057,0,0,17,23,21,6,16,83
ASV7747,0,10,0,19,35,5,14,83
ASV8101,3,14,39,8,0,6,13,83
ASV9912,0,6,0,0,12,0,65,83
ASV10650,21,0,0,12,44,6,0,83
ASV10798,0,3,71,0,1,2,6,83
ASV11267,26,25,16,5,1,2,8,83
ASV12569,19,0,17,5,3,15,24,83
ASV14708,0,25,25,9,10,0,14,83
ASV15262,16,7,4,13,24,4,15,83
ASV17674,4,0,0,0,11,0,68,83
ASV324,6,2,18,16,16,7,17,82
ASV485,0,10,15,9,21,14,13,82
ASV1278,6,16,0,10,13,3,34,82
ASV1345,0,4,27,0,2,19,30,82
ASV1567,0,13,6,0,55,8,0,82
ASV5683,11,8,16,4,0,15,28,82
ASV6913,0,9,29,1,12,17,14,82
ASV7004,0,12,34,17,11,7,1,82
ASV10375,0,4,0,0,0,2,76,82
ASV14207,0,4,12,15,4,4,43,82
ASV21546,0,5,29,0,6,6,36,82
ASV21949,16,8,36,0,18,4,0,82
ASV1258,0,0,30,16,0,22,13,81
ASV2166,8,1,7,30,16,14,5,81
ASV2205,0,6,5,5,42,0,23,81
ASV2502,8,9,16,23,10,13,2,81
ASV4456,12,18,14,14,20,3,0,81
ASV4579,4,11,28,25,1,12,0,81
ASV9640,6,7,6,4,41,3,14,81
ASV12137,0,5,9,12,20,16,19,81
ASV14541,0,20,16,4,27,5,9,81
ASV18517,0,81,0,0,0,0,0,81
ASV572,0,14,15,0,10,3,38,80
ASV1700,0,4,25,0,36,12,3,80
ASV1777,0,31,0,0,49,0,0,80
ASV2074,5,20,18,9,12,2,14,80
ASV2337,3,0,17,6,44,5,5,80
ASV2345,0,70,0,0,7,3,0,80
ASV3071,0,12,30,3,18,7,10,80
ASV3699,0,0,11,0,4,0,65,80
ASV3781,2,0,23,8,6,4,37,80
ASV4435,0,0,5,10,21,6,38,80
ASV4527,0,12,2,6,32,10,18,80
ASV6034,18,0,11,9,32,0,10,80
ASV7543,0,10,25,0,1,29,15,80
ASV8591,22,0,3,6,9,22,18,80
ASV9982,0,13,16,13,16,9,13,80
ASV10604,0,0,55,10,0,9,6,80
ASV11555,0,0,25,0,38,17,0,80
ASV12350,0,28,10,14,10,5,13,80
ASV15927,0,12,20,5,11,32,0,80
ASV16548,2,15,8,21,3,13,18,80
ASV16674,0,0,0,80,0,0,0,80
ASV17198,0,0,2,28,21,16,13,80
ASV1112,11,4,15,15,20,3,11,79
ASV1506,5,7,0,53,6,8,0,79
ASV1590,3,6,12,5,15,38,0,79
ASV3510,7,1,28,0,22,8,13,79
ASV3930,0,29,0,16,9,4,21,79
ASV3977,0,8,19,16,22,14,0,79
ASV4386,11,9,24,5,10,12,8,79
ASV6443,0,3,7,10,22,28,9,79
ASV6549,0,3,1,0,38,0,37,79
ASV8067,12,19,25,10,5,2,6,79
ASV9042,5,3,2,2,16,36,15,79
ASV10366,5,0,14,24,36,0,0,79
ASV11813,16,0,27,6,17,4,9,79
ASV13113,17,13,5,13,5,16,10,79
ASV13537,0,0,0,79,0,0,0,79
ASV14539,36,17,0,5,0,3,18,79
ASV14594,0,2,72,1,0,4,0,79
ASV16457,0,0,11,25,35,0,8,79
ASV18106,27,19,0,0,7,19,7,79
ASV264,0,0,54,6,13,0,5,78
ASV404,0,7,13,18,5,3,32,78
ASV1318,0,0,32,21,16,7,2,78
ASV1861,0,8,21,10,3,28,8,78
ASV1865,33,5,0,25,3,8,4,78
ASV1947,0,0,20,17,0,15,26,78
ASV3562,7,3,17,26,0,8,17,78
ASV4634,2,14,3,24,6,7,22,78
ASV5169,0,0,10,58,0,10,0,78
ASV8414,5,4,18,25,10,1,15,78
ASV9888,2,4,20,32,8,4,8,78
ASV12357,0,0,0,0,7,0,71,78
ASV12449,0,23,0,31,24,0,0,78
ASV13648,0,0,0,20,0,25,33,78
ASV13955,6,4,3,11,33,2,19,78
ASV16648,9,1,23,11,4,20,10,78
ASV17838,0,20,35,6,4,2,11,78
ASV19579,24,4,6,2,36,5,1,78
ASV24702,0,48,11,7,1,11,0,78
ASV431,3,9,0,11,9,10,35,77
ASV593,3,3,17,21,3,26,4,77
ASV1452,0,7,23,13,14,0,20,77
ASV4030,0,17,14,4,0,2,40,77
ASV4956,0,8,13,11,19,0,26,77
ASV5009,0,7,3,12,14,7,34,77
ASV5140,0,3,22,13,24,12,3,77
ASV6781,0,4,22,9,2,20,20,77
ASV7498,0,1,10,16,21,6,23,77
ASV8630,35,0,0,17,5,20,0,77
ASV10046,0,0,2,27,36,0,12,77
ASV11500,1,0,32,5,15,4,20,77
ASV11739,0,0,26,6,31,12,2,77
ASV14538,0,0,0,0,0,77,0,77
ASV14829,0,32,18,0,27,0,0,77
ASV17885,0,0,0,1,65,0,11,77
ASV19262,0,17,0,12,0,22,26,77
ASV20096,77,0,0,0,0,0,0,77
ASV1343,10,0,31,0,1,25,9,76
ASV1816,0,24,4,17,0,5,26,76
ASV3052,8,8,23,13,6,14,4,76
ASV4253,17,0,0,0,28,0,31,76
ASV5297,0,7,17,18,4,17,13,76
ASV6135,0,14,45,0,2,10,5,76
ASV7598,0,8,21,3,16,23,5,76
ASV8636,0,0,11,49,2,0,14,76
ASV9836,0,11,13,0,0,0,52,76
ASV12034,0,7,3,4,7,9,46,76
ASV13901,6,0,12,5,3,14,36,76
ASV14289,0,0,11,5,7,37,16,76
ASV15053,3,11,22,5,17,14,4,76
ASV16907,0,1,15,39,15,1,5,76
ASV17005,14,6,5,6,14,16,15,76
ASV20054,37,12,3,0,17,2,5,76
ASV20435,0,76,0,0,0,0,0,76
ASV20935,5,0,12,18,16,13,12,76
ASV21896,2,15,8,21,21,3,6,76
ASV1292,3,0,30,3,16,0,23,75
ASV2776,0,4,11,11,33,0,16,75
ASV3223,0,0,6,18,0,29,22,75
ASV3428,0,8,10,25,8,13,11,75
ASV5026,0,0,37,14,0,24,0,75
ASV5704,0,7,6,6,4,17,35,75
ASV6876,0,3,7,47,4,0,14,75
ASV7891,0,35,0,9,0,0,31,75
ASV8553,3,0,25,13,11,15,8,75
ASV8623,0,0,35,22,13,5,0,75
ASV9249,14,14,1,8,11,9,18,75
ASV10452,0,7,10,26,9,11,12,75
ASV13926,0,3,13,18,0,22,19,75
ASV15414,0,7,13,13,6,30,6,75
ASV16324,0,0,0,0,1,5,69,75
ASV16711,2,0,14,12,30,9,8,75
ASV19611,0,9,6,6,9,15,30,75
ASV22291,5,3,6,19,20,0,22,75
ASV23817,34,6,7,0,0,28,0,75
ASV27013,0,18,22,0,5,21,9,75
ASV304,4,4,3,8,4,15,36,74
ASV1194,11,8,13,15,4,8,15,74
ASV2498,0,13,25,0,13,0,23,74
ASV3353,41,5,14,0,5,4,5,74
ASV4657,0,0,13,8,12,34,7,74
ASV5213,2,4,1,9,26,3,29,74
ASV7686,0,5,0,12,51,4,2,74
ASV8308,13,0,5,8,6,3,39,74
ASV9007,2,3,13,10,4,29,13,74
ASV9810,0,35,0,20,19,0,0,74
ASV11763,0,14,27,15,5,1,12,74
ASV12039,1,19,11,6,12,25,0,74
ASV18139,1,21,16,14,5,4,13,74
ASV20063,0,14,8,0,3,21,28,74
ASV20800,0,0,72,0,0,2,0,74
ASV21928,0,35,0,11,14,1,13,74
ASV22017,0,0,0,74,0,0,0,74
ASV71,2,12,12,11,3,16,17,73
ASV151,0,6,9,9,12,30,7,73
ASV557,9,15,26,5,7,11,0,73
ASV1231,0,9,12,0,14,24,14,73
ASV1487,0,0,10,0,33,15,15,73
ASV2327,12,10,0,16,11,19,5,73
ASV3013,0,0,0,0,0,5,68,73
ASV4089,0,3,0,2,34,21,13,73
ASV6554,3,1,34,9,10,8,8,73
ASV7410,3,7,14,15,0,22,12,73
ASV8119,5,9,15,14,7,7,16,73
ASV8738,0,8,9,10,15,0,31,73
ASV11427,0,0,28,18,15,10,2,73
ASV11554,20,5,4,3,29,7,5,73
ASV12656,0,66,0,0,0,0,7,73
ASV15122,3,0,6,8,23,16,17,73
ASV15413,0,0,6,2,65,0,0,73
ASV19177,6,13,18,8,16,6,6,73
ASV703,0,0,19,0,24,13,16,72
ASV710,0,9,28,12,12,7,4,72
ASV2123,1,0,16,6,34,13,2,72
ASV3275,0,3,24,17,21,6,1,72
ASV4097,0,3,35,18,10,3,3,72
ASV4279,8,4,5,13,22,3,17,72
ASV5844,16,0,0,0,38,2,16,72
ASV6004,14,14,7,8,17,10,2,72
ASV6210,0,1,1,5,3,58,4,72
ASV9864,0,0,16,28,0,12,16,72
ASV10379,0,2,4,66,0,0,0,72
ASV13148,0,7,1,19,37,3,5,72
ASV13492,0,6,0,23,0,0,43,72
ASV14705,0,3,11,5,0,0,53,72
ASV15524,0,10,24,7,0,26,5,72
ASV17029,0,3,9,8,8,0,44,72
ASV21145,6,0,2,18,28,5,13,72
ASV23547,0,17,24,0,22,1,8,72
ASV24213,0,1,17,32,5,17,0,72
ASV481,0,0,32,0,4,0,35,71
ASV610,66,0,0,0,0,0,5,71
ASV692,0,15,3,5,23,22,3,71
ASV1379,0,8,17,0,2,18,26,71
ASV3425,0,0,18,6,14,18,15,71
ASV4452,6,2,4,18,27,3,11,71
ASV5308,7,19,6,0,0,4,35,71
ASV5326,0,1,16,4,12,10,28,71
ASV5641,0,0,8,23,32,2,6,71
ASV5744,0,0,5,0,1,40,25,71
ASV6265,20,6,2,35,0,0,8,71
ASV7086,0,0,49,0,0,22,0,71
ASV7532,5,4,4,18,21,9,10,71
ASV8278,0,0,70,0,0,1,0,71
ASV9992,0,0,19,35,0,12,5,71
ASV12057,0,0,22,0,1,48,0,71
ASV12970,10,14,18,11,6,9,3,71
ASV13345,0,0,9,31,0,22,9,71
ASV13690,6,9,5,14,4,13,20,71
ASV15778,5,1,0,15,1,0,49,71
ASV15911,0,69,0,0,2,0,0,71
ASV21015,0,3,0,43,14,0,11,71
ASV21437,6,1,16,22,7,6,13,71
ASV536,0,70,0,0,0,0,0,70
ASV694,0,3,0,3,0,0,64,70
ASV2076,5,0,18,26,12,9,0,70
ASV2791,0,62,0,2,3,0,3,70
ASV2819,1,17,0,6,33,0,13,70
ASV3641,0,0,0,39,0,18,13,70
ASV5130,0,0,11,15,12,15,17,70
ASV6784,0,0,0,0,64,0,6,70
ASV7393,0,0,4,9,3,0,54,70
ASV7568,0,0,11,9,27,23,0,70
ASV9735,0,33,17,3,0,17,0,70
ASV11171,0,0,2,0,0,68,0,70
ASV13175,2,24,14,11,0,5,14,70
ASV21167,0,0,0,0,0,70,0,70
ASV22858,0,0,0,70,0,0,0,70
ASV25723,3,37,0,23,6,0,1,70
ASV26141,0,0,69,1,0,0,0,70
ASV76,0,10,15,6,6,24,8,69
ASV346,0,0,21,29,16,0,3,69
ASV1636,4,5,3,7,6,21,23,69
ASV3795,0,3,4,21,24,11,6,69
ASV3892,0,1,33,4,0,31,0,69
ASV5310,0,22,3,14,6,6,18,69
ASV5487,0,0,23,11,15,13,7,69
ASV5764,0,16,0,14,16,0,23,69
ASV6830,0,9,11,8,17,2,22,69
ASV6935,6,8,6,2,1,37,9,69
ASV6949,23,18,2,1,12,0,13,69
ASV7466,4,7,7,24,11,12,4,69
ASV11262,16,0,0,4,11,28,10,69
ASV11334,0,4,0,1,61,0,3,69
ASV13232,0,0,18,2,16,25,8,69
ASV14494,5,0,0,62,2,0,0,69
ASV16255,0,2,0,2,0,20,45,69
ASV18085,0,0,21,6,18,16,8,69
ASV22388,0,0,4,49,0,0,16,69
ASV23872,0,0,0,69,0,0,0,69
ASV583,0,0,5,8,11,13,31,68
ASV1158,0,17,4,17,8,0,22,68
ASV2093,0,0,24,8,12,8,16,68
ASV2164,10,8,6,12,13,11,8,68
ASV2919,0,9,19,2,9,9,20,68
ASV5541,0,30,0,0,10,1,27,68
ASV6761,0,17,2,8,11,16,14,68
ASV7517,0,0,57,11,0,0,0,68
ASV7689,0,0,0,13,10,0,45,68
ASV9477,0,4,8,3,8,22,23,68
ASV10755,9,7,22,9,18,2,1,68
ASV12889,0,0,11,9,9,39,0,68
ASV14242,0,0,15,0,53,0,0,68
ASV15779,11,12,5,2,19,9,10,68
ASV17219,4,1,30,9,11,9,4,68
ASV17839,0,0,0,0,0,68,0,68
ASV18022,1,3,16,12,25,4,7,68
ASV21088,0,0,0,0,0,1,67,68
ASV21415,0,0,0,5,63,0,0,68
ASV22386,24,9,16,6,0,13,0,68
ASV24575,10,8,22,0,2,0,26,68
ASV1035,0,0,6,15,32,0,14,67
ASV1510,0,1,0,52,0,13,1,67
ASV2351,2,5,5,19,25,7,4,67
ASV2517,0,0,23,19,1,13,11,67
ASV4455,0,0,67,0,0,0,0,67
ASV6168,5,0,25,8,12,7,10,67
ASV7184,6,1,11,14,29,0,6,67
ASV7251,12,2,1,44,2,6,0,67
ASV7682,0,0,22,5,12,13,15,67
ASV7908,0,0,5,11,5,4,42,67
ASV9930,0,6,11,26,22,0,2,67
ASV13476,8,0,5,31,4,2,17,67
ASV15144,0,16,7,19,7,10,8,67
ASV16038,0,4,63,0,0,0,0,67
ASV18217,0,7,31,0,26,0,3,67
ASV20244,0,0,16,38,3,3,7,67
ASV22985,0,0,0,2,6,53,6,67
ASV23295,0,0,18,0,0,49,0,67
ASV363,0,4,0,15,29,0,18,66
ASV1154,0,12,0,24,9,0,21,66
ASV1350,62,0,0,0,0,4,0,66
ASV2063,0,11,23,0,16,3,13,66
ASV2275,0,5,0,11,3,17,30,66
ASV2360,12,0,8,19,17,4,6,66
ASV2539,4,0,10,5,27,0,20,66
ASV3744,0,0,0,45,18,0,3,66
ASV4473,0,0,4,11,29,5,17,66
ASV4698,0,21,1,12,12,0,20,66
ASV5231,0,0,6,25,3,13,19,66
ASV5611,0,10,13,0,0,17,26,66
ASV6016,0,8,11,0,7,32,8,66
ASV6440,0,12,15,0,37,0,2,66
ASV6731,29,0,0,0,7,0,30,66
ASV9094,9,5,7,15,14,0,16,66
ASV10230,5,0,15,19,2,9,16,66
ASV10494,4,7,19,22,10,3,1,66
ASV10846,10,13,0,27,9,7,0,66
ASV11505,0,4,8,3,18,7,26,66
ASV13842,16,13,4,0,3,30,0,66
ASV14121,2,18,12,8,1,3,22,66
ASV15113,5,0,0,0,8,0,53,66
ASV15538,0,3,18,23,15,0,7,66
ASV18790,0,0,0,25,18,3,20,66
ASV20320,0,0,0,0,0,0,66,66
ASV20941,0,16,38,0,0,12,0,66
ASV21954,0,4,12,23,16,5,6,66
ASV1353,0,12,6,16,8,12,11,65
ASV1500,0,0,20,4,6,35,0,65
ASV2469,1,0,15,16,0,18,15,65
ASV2574,8,16,16,0,11,14,0,65
ASV2944,0,13,52,0,0,0,0,65
ASV3716,0,2,2,6,29,0,26,65
ASV4491,56,0,0,3,0,6,0,65
ASV4731,9,0,4,17,6,0,29,65
ASV4998,22,0,5,0,8,0,30,65
ASV5669,0,19,26,5,5,0,10,65
ASV6436,0,0,31,12,0,21,1,65
ASV6687,0,14,11,5,8,14,13,65
ASV8305,0,13,4,17,7,24,0,65
ASV9758,0,0,21,8,0,36,0,65
ASV11041,0,27,3,19,11,5,0,65
ASV13795,0,14,23,9,14,0,5,65
ASV14807,0,17,24,0,13,0,11,65
ASV16746,0,15,13,0,0,18,19,65
ASV21396,1,1,26,5,4,8,20,65
ASV751,0,5,27,9,2,16,5,64
ASV1645,0,2,0,11,21,8,22,64
ASV2002,0,8,2,16,9,14,15,64
ASV3693,8,5,18,12,6,6,9,64
ASV4009,0,0,0,33,0,0,31,64
ASV4320,0,11,4,20,11,0,18,64
ASV4347,15,0,8,36,0,4,1,64
ASV4423,0,10,10,13,3,0,28,64
ASV6278,0,0,8,56,0,0,0,64
ASV6506,0,20,0,0,0,44,0,64
ASV6557,53,0,5,0,0,6,0,64
ASV6826,0,8,3,18,26,0,9,64
ASV7545,0,0,10,21,3,26,4,64
ASV10164,11,9,37,2,0,1,4,64
ASV11189,0,9,18,0,12,9,16,64
ASV11268,0,0,10,23,18,5,8,64
ASV11838,1,0,21,4,9,23,6,64
ASV11966,0,2,28,16,0,16,2,64
ASV14179,10,10,3,0,8,17,16,64
ASV14444,0,0,0,19,0,8,37,64
ASV16425,4,0,22,15,14,5,4,64
ASV17006,0,0,0,0,13,6,45,64
ASV17698,0,6,12,11,26,2,7,64
ASV19011,0,4,28,9,4,19,0,64
ASV20302,0,0,19,4,3,22,16,64
ASV21318,0,7,0,10,39,0,8,64
ASV23357,0,0,22,8,10,7,17,64
ASV1276,13,25,0,0,0,0,25,63
ASV1707,0,0,16,12,11,20,4,63
ASV1806,5,27,5,0,16,0,10,63
ASV4104,11,1,31,2,1,6,11,63
ASV4566,6,0,25,0,0,32,0,63
ASV4649,0,11,6,9,15,5,17,63
ASV6679,0,56,0,7,0,0,0,63
ASV6818,4,0,13,0,4,30,12,63
ASV8428,0,6,23,31,0,0,3,63
ASV8797,0,6,19,9,14,10,5,63
ASV8892,0,0,12,25,8,18,0,63
ASV9031,0,0,12,2,8,16,25,63
ASV9424,0,10,12,0,20,3,18,63
ASV10376,0,12,11,26,3,0,11,63
ASV10849,0,13,11,4,14,8,13,63
ASV11401,0,11,9,12,13,0,18,63
ASV14224,26,0,13,2,0,16,6,63
ASV14296,7,4,5,27,20,0,0,63
ASV15667,0,0,5,5,0,53,0,63
ASV16246,0,0,14,0,1,26,22,63
ASV16573,18,0,0,0,10,14,21,63
ASV18587,9,4,12,0,0,26,12,63
ASV21175,0,63,0,0,0,0,0,63
ASV25177,0,0,58,0,0,0,5,63
ASV27092,4,26,0,14,4,13,2,63
ASV103,0,9,16,0,0,14,23,62
ASV458,0,4,0,4,0,25,29,62
ASV935,0,1,18,6,13,17,7,62
ASV939,0,0,0,1,21,0,40,62
ASV966,0,15,25,8,12,2,0,62
ASV1876,0,3,15,5,0,12,27,62
ASV3466,1,0,39,11,4,6,1,62
ASV6864,0,8,16,0,0,23,15,62
ASV7130,2,3,20,8,13,9,7,62
ASV7540,0,22,0,0,28,5,7,62
ASV7588,0,31,0,31,0,0,0,62
ASV7736,1,0,61,0,0,0,0,62
ASV9610,3,2,21,11,9,2,14,62
ASV11588,0,10,11,4,8,9,20,62
ASV12519,0,0,0,62,0,0,0,62
ASV12751,0,0,0,62,0,0,0,62
ASV14175,0,4,6,32,11,6,3,62
ASV14527,0,0,62,0,0,0,0,62
ASV18430,0,0,1,61,0,0,0,62
ASV19338,0,17,18,2,20,0,5,62
ASV20022,0,0,0,8,48,0,6,62
ASV21152,0,0,11,10,20,17,4,62
ASV23409,5,0,46,0,0,0,11,62
ASV23469,0,0,0,0,0,62,0,62
ASV24013,62,0,0,0,0,0,0,62
ASV591,9,0,10,23,1,0,18,61
ASV715,13,0,12,5,13,12,6,61
ASV992,7,8,1,0,45,0,0,61
ASV1033,13,9,27,3,2,0,7,61
ASV1735,0,0,0,5,21,29,6,61
ASV1737,0,4,11,11,21,5,9,61
ASV2460,0,3,14,29,3,12,0,61
ASV2761,0,2,2,4,28,8,17,61
ASV2816,0,6,5,16,0,11,23,61
ASV2918,0,0,9,31,12,0,9,61
ASV3596,0,2,0,2,2,40,15,61
ASV3689,4,0,16,18,2,12,9,61
ASV4660,0,5,10,2,15,5,24,61
ASV6788,3,0,26,2,4,0,26,61
ASV6957,0,12,11,8,25,0,5,61
ASV7544,0,5,9,2,1,28,16,61
ASV8590,0,1,6,5,24,24,1,61
ASV9248,0,22,10,9,5,15,0,61
ASV9301,0,6,55,0,0,0,0,61
ASV11139,0,4,13,22,10,5,7,61
ASV11880,0,3,1,11,11,28,7,61
ASV12088,6,15,3,11,13,3,10,61
ASV12202,0,8,0,3,1,0,49,61
ASV13099,0,7,15,12,3,9,15,61
ASV14033,17,6,24,11,3,0,0,61
ASV17549,51,10,0,0,0,0,0,61
ASV18590,4,7,12,16,10,5,7,61
ASV20792,0,0,61,0,0,0,0,61
ASV21063,0,16,11,3,31,0,0,61
ASV752,6,0,8,12,6,7,21,60
ASV1034,0,0,10,14,0,33,3,60
ASV1565,3,15,17,4,2,19,0,60
ASV1799,5,0,0,0,15,0,40,60
ASV2124,0,0,0,0,0,0,60,60
ASV2463,3,1,2,10,13,12,19,60
ASV3953,0,0,7,28,4,10,11,60
ASV4857,6,16,25,1,0,7,5,60
ASV5182,7,9,10,6,15,6,7,60
ASV5394,0,25,21,0,0,14,0,60
ASV5591,0,24,9,22,4,0,1,60
ASV5819,10,2,9,14,0,18,7,60
ASV6815,4,14,6,2,10,14,10,60
ASV6916,0,6,19,17,5,0,13,60
ASV7208,8,0,23,2,10,17,0,60
ASV7269,8,8,8,8,15,3,10,60
ASV8091,0,0,11,21,12,4,12,60
ASV10944,0,4,7,19,9,4,17,60
ASV11204,4,2,14,6,12,16,6,60
ASV11299,0,0,0,0,14,27,19,60
ASV14559,0,0,0,0,0,33,27,60
ASV15417,0,0,0,7,11,13,29,60
ASV16284,0,9,7,0,14,11,19,60
ASV17084,9,44,0,0,0,0,7,60
ASV18251,0,0,60,0,0,0,0,60
ASV18534,0,4,25,0,2,21,8,60
ASV20015,0,0,31,12,0,12,5,60
ASV22831,0,0,0,55,0,4,1,60
ASV25879,11,6,8,4,0,26,5,60
ASV26380,0,1,17,0,0,36,6,60
ASV29,0,0,18,4,14,5,18,59
ASV205,5,7,6,14,0,16,11,59
ASV337,2,13,21,4,11,8,0,59
ASV1515,0,7,15,0,4,24,9,59
ASV1998,0,2,13,10,14,9,11,59
ASV2535,0,0,0,0,10,43,6,59
ASV3158,0,5,0,0,0,39,15,59
ASV4062,0,0,15,10,10,11,13,59
ASV4068,0,9,0,1,4,4,41,59
ASV4153,0,18,2,2,19,0,18,59
ASV4211,0,4,14,10,7,17,7,59
ASV4558,0,0,12,17,18,5,7,59
ASV4771,0,0,10,0,0,47,2,59
ASV4865,0,0,21,27,9,0,2,59
ASV7613,8,14,0,22,3,0,12,59
ASV8374,0,0,15,43,0,0,1,59
ASV9113,0,0,0,59,0,0,0,59
ASV9177,2,1,1,16,23,5,11,59
ASV10417,0,1,1,1,19,25,12,59
ASV11566,7,0,1,15,5,9,22,59
ASV12511,0,0,1,4,21,11,22,59
ASV13630,1,9,0,0,16,0,33,59
ASV14477,0,0,0,25,31,0,3,59
ASV14865,0,13,8,11,10,5,12,59
ASV15912,0,5,13,2,13,4,22,59
ASV17260,0,8,6,0,10,0,35,59
ASV18229,0,0,31,4,0,24,0,59
ASV18262,0,24,4,12,12,0,7,59
ASV19732,0,45,0,0,0,6,8,59
ASV20783,0,7,40,0,12,0,0,59
ASV20793,15,0,13,0,12,13,6,59
ASV20871,20,1,9,10,16,3,0,59
ASV24407,23,10,10,5,3,6,2,59
ASV286,3,0,37,0,8,3,7,58
ASV1514,0,0,5,4,6,21,22,58
ASV1602,8,5,8,19,10,2,6,58
ASV2047,0,2,1,14,30,3,8,58
ASV2348,0,15,4,12,0,21,6,58
ASV3126,5,4,7,8,2,0,32,58
ASV3286,0,16,5,12,14,9,2,58
ASV3362,26,19,5,7,1,0,0,58
ASV3878,0,14,8,2,6,25,3,58
ASV4726,0,6,4,9,17,17,5,58
ASV5208,38,1,0,13,0,0,6,58
ASV5941,8,5,20,2,1,0,22,58
ASV5982,0,3,4,21,21,0,9,58
ASV7617,13,10,0,0,0,0,35,58
ASV7744,0,26,0,2,0,0,30,58
ASV9276,3,18,10,11,3,13,0,58
ASV9605,0,6,17,0,0,11,24,58
ASV11997,7,5,0,5,0,41,0,58
ASV13416,0,0,16,0,11,0,31,58
ASV13422,17,2,4,0,14,13,8,58
ASV15088,0,3,6,3,10,14,22,58
ASV16584,0,0,0,0,0,0,58,58
ASV17683,0,0,0,3,55,0,0,58
ASV22153,0,0,0,52,0,0,6,58
ASV263,5,2,3,0,11,20,16,57
ASV343,3,9,0,10,8,2,25,57
ASV450,8,4,15,5,6,12,7,57
ASV2212,5,3,13,8,5,18,5,57
ASV2888,0,2,17,15,9,6,8,57
ASV4181,3,0,6,12,4,22,10,57
ASV6128,0,27,13,8,0,0,9,57
ASV7896,0,12,23,10,7,0,5,57
ASV8099,27,1,0,0,5,0,24,57
ASV8332,0,3,35,0,0,19,0,57
ASV8697,0,0,11,27,0,9,10,57
ASV9084,0,0,42,1,13,1,0,57
ASV9751,0,0,2,0,8,0,47,57
ASV10050,0,3,16,12,6,0,20,57
ASV10110,0,0,21,36,0,0,0,57
ASV11384,17,7,17,4,0,0,12,57
ASV12184,29,0,13,4,0,0,11,57
ASV12689,5,7,7,7,16,4,11,57
ASV12997,0,0,0,0,0,57,0,57
ASV13765,0,3,0,0,52,0,2,57
ASV14885,2,0,0,6,5,44,0,57
ASV15493,0,0,0,0,0,0,57,57
ASV15994,15,5,9,4,14,10,0,57
ASV16151,0,20,4,0,11,19,3,57
ASV17229,0,0,11,3,8,2,33,57
ASV18995,0,4,0,19,15,0,19,57
ASV19488,0,5,0,15,17,1,19,57
ASV20955,2,0,27,3,9,16,0,57
ASV21706,0,0,12,15,15,5,10,57
ASV26528,20,0,0,16,21,0,0,57
ASV798,9,25,4,2,0,16,0,56
ASV1406,0,0,0,0,3,4,49,56
ASV1473,0,2,26,3,16,9,0,56
ASV1641,0,0,25,8,1,12,10,56
ASV2959,0,25,3,10,5,6,7,56
ASV3449,4,0,0,37,2,5,8,56
ASV3522,0,11,8,3,0,34,0,56
ASV3556,0,12,0,9,14,0,21,56
ASV3871,0,0,22,1,20,10,3,56
ASV4399,13,7,4,0,2,30,0,56
ASV5293,9,0,0,0,36,0,11,56
ASV5702,0,0,14,9,27,0,6,56
ASV7796,7,0,1,30,7,0,11,56
ASV8522,0,0,0,0,11,0,45,56
ASV8955,0,0,9,6,32,8,1,56
ASV13189,2,0,33,13,0,8,0,56
ASV16564,0,0,1,0,0,55,0,56
ASV16781,0,7,26,6,5,2,10,56
ASV17241,15,11,11,5,0,12,2,56
ASV17612,1,7,17,13,1,0,17,56
ASV18967,0,10,0,31,3,9,3,56
ASV21961,0,0,29,0,0,18,9,56
ASV21962,0,11,0,25,8,0,12,56
ASV22425,0,0,52,0,0,0,4,56
ASV26790,0,0,0,7,28,17,4,56
ASV134,24,0,4,16,8,2,1,55
ASV650,0,9,13,0,4,0,29,55
ASV1075,0,4,6,0,5,40,0,55
ASV1155,11,1,17,4,10,1,11,55
ASV1321,0,0,0,55,0,0,0,55
ASV2369,0,2,27,3,0,10,13,55
ASV3099,0,10,8,1,0,1,35,55
ASV3222,2,4,0,1,1,2,45,55
ASV3810,0,0,0,0,4,51,0,55
ASV3920,3,2,13,8,18,1,10,55
ASV4003,0,16,24,8,0,2,5,55
ASV4484,0,12,6,13,0,16,8,55
ASV4531,17,0,33,5,0,0,0,55
ASV4932,6,9,17,6,6,5,6,55
ASV5046,0,0,3,3,12,0,37,55
ASV5340,0,6,15,7,19,0,8,55
ASV6205,0,14,0,15,21,5,0,55
ASV6385,2,0,8,9,4,3,29,55
ASV7299,0,1,22,10,0,16,6,55
ASV7570,2,19,1,3,26,0,4,55
ASV8538,4,12,11,6,2,16,4,55
ASV8632,0,17,0,0,0,28,10,55
ASV8677,0,0,0,33,5,4,13,55
ASV9230,6,4,1,3,10,10,21,55
ASV10505,0,0,0,0,0,0,55,55
ASV12343,7,0,3,0,0,31,14,55
ASV13093,0,0,0,7,34,0,14,55
ASV14736,47,8,0,0,0,0,0,55
ASV15772,0,21,1,0,5,2,26,55
ASV16312,0,0,9,21,13,4,8,55
ASV16671,0,0,3,0,7,6,39,55
ASV16768,0,49,0,0,6,0,0,55
ASV19928,0,14,36,5,0,0,0,55
ASV21342,0,0,0,7,18,0,30,55
ASV24529,0,0,10,25,4,2,14,55
ASV24701,0,0,7,0,46,2,0,55
ASV26217,5,1,4,9,11,18,7,55
ASV27034,3,12,5,2,12,13,8,55
ASV118,8,24,1,0,0,13,8,54
ASV1524,0,0,19,16,0,0,19,54
ASV2643,0,3,6,5,4,17,19,54
ASV3220,21,3,5,3,8,7,7,54
ASV4288,0,0,0,0,0,0,54,54
ASV4301,0,0,5,3,6,0,40,54
ASV5655,0,3,17,4,12,8,10,54
ASV6398,0,0,16,17,6,8,7,54
ASV6685,0,0,0,54,0,0,0,54
ASV6873,5,3,0,33,0,0,13,54
ASV7289,0,0,17,16,1,2,18,54
ASV7786,13,8,0,20,10,0,3,54
ASV7807,0,0,0,0,0,15,39,54
ASV8163,0,0,11,0,0,6,37,54
ASV8210,0,0,0,54,0,0,0,54
ASV8390,2,0,0,22,6,4,20,54
ASV8466,0,8,19,0,6,17,4,54
ASV8948,0,33,0,12,0,0,9,54
ASV9822,0,3,16,7,16,0,12,54
ASV10204,0,0,0,54,0,0,0,54
ASV10703,0,0,5,19,5,25,0,54
ASV11080,0,0,0,0,0,0,54,54
ASV12378,0,10,0,0,28,16,0,54
ASV13730,0,13,6,16,10,9,0,54
ASV14506,0,35,19,0,0,0,0,54
ASV18876,0,52,0,2,0,0,0,54
ASV19710,5,8,4,30,7,0,0,54
ASV22940,0,0,0,54,0,0,0,54
ASV25359,0,54,0,0,0,0,0,54
ASV489,2,0,15,20,1,8,7,53
ASV1000,0,0,10,10,27,0,6,53
ASV1899,0,0,11,0,7,27,8,53
ASV2280,0,0,4,31,4,7,7,53
ASV2476,0,5,0,0,3,0,45,53
ASV3474,0,0,12,3,3,27,8,53
ASV4078,0,7,14,11,0,7,14,53
ASV5272,0,0,18,0,2,0,33,53
ASV5834,3,10,3,0,0,33,4,53
ASV5965,20,3,16,4,2,1,7,53
ASV7113,0,0,0,0,1,24,28,53
ASV8178,0,0,0,27,1,20,5,53
ASV9271,0,0,0,47,0,6,0,53
ASV10999,6,10,3,12,22,0,0,53
ASV12767,0,0,5,29,11,0,8,53
ASV15142,5,0,0,1,35,0,12,53
ASV16929,0,5,6,14,3,9,16,53
ASV20156,0,2,20,5,17,0,9,53
ASV20290,7,0,2,10,15,0,19,53
ASV21104,6,0,0,1,45,1,0,53
ASV21772,0,0,0,43,0,0,10,53
ASV2077,4,0,39,1,2,6,0,52
ASV2905,11,2,0,33,1,5,0,52
ASV3373,0,5,0,17,15,0,15,52
ASV4934,1,0,13,35,0,0,3,52
ASV5074,0,0,7,7,21,1,16,52
ASV5618,6,0,21,7,3,13,2,52
ASV6777,16,6,0,0,7,15,8,52
ASV7001,0,9,6,5,12,6,14,52
ASV7227,0,19,19,0,0,12,2,52
ASV9320,35,0,0,0,17,0,0,52
ASV10237,0,0,16,26,10,0,0,52
ASV10834,0,0,16,31,0,0,5,52
ASV11996,17,11,3,7,0,3,11,52
ASV12476,16,12,9,3,0,9,3,52
ASV13449,0,0,0,0,32,20,0,52
ASV14053,0,4,0,11,27,2,8,52
ASV15119,0,29,0,0,19,4,0,52
ASV18633,1,6,12,0,33,0,0,52
ASV959,6,38,0,0,6,0,1,51
ASV1939,0,10,2,11,13,1,14,51
ASV2550,0,0,10,0,18,21,2,51
ASV4179,0,0,0,17,19,2,13,51
ASV5158,0,6,22,4,0,15,4,51
ASV5374,0,0,21,11,6,13,0,51
ASV5421,2,0,12,9,10,5,13,51
ASV5752,0,0,0,0,43,2,6,51
ASV6083,0,0,5,27,5,2,12,51
ASV6680,11,5,14,9,8,1,3,51
ASV7502,0,3,18,2,15,6,7,51
ASV8555,0,0,2,1,7,0,41,51
ASV8969,0,27,3,0,0,0,21,51
ASV9054,0,8,0,7,30,0,6,51
ASV9158,0,6,12,0,10,0,23,51
ASV9730,0,5,9,0,25,0,12,51
ASV9872,0,20,14,0,1,9,7,51
ASV10057,0,8,8,12,10,4,9,51
ASV10249,0,12,3,2,6,3,25,51
ASV10434,0,13,8,8,9,0,13,51
ASV10660,0,11,4,5,17,5,9,51
ASV10675,0,0,0,0,3,48,0,51
ASV12268,4,0,19,8,7,12,1,51
ASV12644,0,0,2,31,18,0,0,51
ASV13790,18,12,0,3,6,4,8,51
ASV14409,4,0,28,9,10,0,0,51
ASV15368,22,0,0,7,16,0,6,51
ASV18438,0,3,10,1,14,13,10,51
ASV22651,0,0,0,0,0,0,51,51
ASV26421,8,39,0,0,0,0,4,51
ASV2265,6,0,26,4,4,7,3,50
ASV3033,0,16,5,8,0,17,4,50
ASV3160,0,0,0,0,27,0,23,50
ASV3830,2,3,5,26,12,0,2,50
ASV4231,3,6,3,11,3,24,0,50
ASV4325,0,12,1,0,28,0,9,50
ASV5415,10,0,3,9,0,0,28,50
ASV5526,0,9,0,25,1,8,7,50
ASV5909,0,0,19,23,8,0,0,50
ASV6243,5,4,7,2,0,14,18,50
ASV7013,0,0,50,0,0,0,0,50
ASV8049,6,14,5,11,8,0,6,50
ASV8192,0,13,16,5,0,14,2,50
ASV8505,45,0,0,0,0,0,5,50
ASV8944,0,2,0,0,9,27,12,50
ASV9078,0,15,6,4,21,0,4,50
ASV10232,15,0,1,11,1,0,22,50
ASV10410,36,14,0,0,0,0,0,50
ASV10601,38,1,6,2,0,3,0,50
ASV11046,0,0,5,0,0,6,39,50
ASV11798,12,0,16,4,10,0,8,50
ASV12581,0,5,24,0,13,5,3,50
ASV13141,0,6,11,20,2,9,2,50
ASV15710,0,0,6,24,9,8,3,50
ASV18135,9,0,2,19,11,9,0,50
ASV18643,0,0,0,7,10,0,33,50
ASV20859,0,0,23,22,3,0,2,50
ASV23675,7,16,15,4,5,0,3,50
ASV708,0,8,20,15,6,0,0,49
ASV1277,0,0,19,7,21,0,2,49
ASV2171,0,0,0,23,6,11,9,49
ASV2316,14,6,4,17,0,0,8,49
ASV3188,15,13,0,18,0,3,0,49
ASV3750,5,0,9,3,8,1,23,49
ASV4219,0,1,5,17,7,11,8,49
ASV4742,0,1,14,25,0,9,0,49
ASV4888,0,0,14,32,3,0,0,49
ASV5223,11,3,0,4,22,0,9,49
ASV5338,0,0,2,0,11,20,16,49
ASV5395,6,1,13,7,12,8,2,49
ASV6365,3,8,24,9,0,0,5,49
ASV6563,0,4,5,11,7,9,13,49
ASV6817,0,0,0,0,0,49,0,49
ASV6908,0,4,31,3,1,1,9,49
ASV7185,5,0,0,20,12,4,8,49
ASV8840,0,0,8,14,0,22,5,49
ASV8919,0,8,21,10,7,1,2,49
ASV9035,0,0,17,7,6,16,3,49
ASV9897,0,2,9,10,6,2,20,49
ASV10011,15,6,11,2,0,10,5,49
ASV10764,0,12,17,0,0,2,18,49
ASV11121,0,5,16,3,5,10,10,49
ASV11698,0,0,0,4,24,10,11,49
ASV11738,22,0,0,7,0,0,20,49
ASV14618,9,8,0,20,12,0,0,49
ASV17792,0,0,0,0,38,0,11,49
ASV18331,6,0,15,1,5,12,10,49
ASV21328,0,11,0,6,20,0,12,49
ASV21910,0,18,0,11,0,0,20,49
ASV206,0,3,12,9,17,0,7,48
ASV280,0,0,9,1,12,4,22,48
ASV397,0,1,47,0,0,0,0,48
ASV713,7,0,21,7,3,7,3,48
ASV1370,0,5,0,12,11,5,15,48
ASV1541,0,0,0,0,0,0,48,48
ASV1582,0,0,7,11,23,1,6,48
ASV2179,0,0,9,3,1,0,35,48
ASV2743,24,3,4,14,0,0,3,48
ASV2967,17,2,12,0,4,7,6,48
ASV3253,0,0,17,7,5,15,4,48
ASV3297,0,0,12,0,32,4,0,48
ASV4878,0,0,18,5,7,14,4,48
ASV5687,0,0,1,9,23,11,4,48
ASV6825,11,2,7,0,0,17,11,48
ASV8082,0,0,0,34,0,14,0,48
ASV9698,17,2,9,11,1,0,8,48
ASV9712,0,0,0,3,2,14,29,48
ASV10132,0,0,0,47,0,0,1,48
ASV10603,3,0,3,19,5,9,9,48
ASV10883,6,0,7,3,20,2,10,48
ASV11074,8,13,5,8,3,8,3,48
ASV11504,16,11,0,0,4,9,8,48
ASV11666,0,6,9,14,5,0,14,48
ASV14127,0,0,16,11,0,16,5,48
ASV14351,0,12,18,9,2,1,6,48
ASV14561,1,0,0,0,0,47,0,48
ASV15140,0,0,0,0,0,0,48,48
ASV15418,0,6,26,0,16,0,0,48
ASV16807,0,4,0,5,18,3,18,48
ASV18180,0,0,0,0,1,0,47,48
ASV20188,6,0,42,0,0,0,0,48
ASV21442,0,3,17,6,12,5,5,48
ASV21541,0,0,17,17,10,2,2,48
ASV21903,0,0,48,0,0,0,0,48
ASV22555,48,0,0,0,0,0,0,48
ASV24623,0,0,1,7,22,17,1,48
ASV24917,1,5,11,15,15,1,0,48
ASV25229,5,11,0,13,10,0,9,48
ASV25462,0,0,48,0,0,0,0,48
ASV460,1,7,12,1,0,7,19,47
ASV954,0,9,15,4,8,0,11,47
ASV1052,0,11,15,18,0,0,3,47
ASV1076,0,0,6,7,28,0,6,47
ASV1783,0,0,5,0,2,40,0,47
ASV1858,0,7,26,2,0,10,2,47
ASV2393,0,3,15,4,7,11,7,47
ASV2420,0,0,11,0,12,23,1,47
ASV3154,0,3,0,5,25,5,9,47
ASV4185,0,5,13,0,5,24,0,47
ASV4366,0,4,4,9,30,0,0,47
ASV4409,0,1,21,13,1,6,5,47
ASV4580,9,0,8,8,16,0,6,47
ASV5257,8,3,10,11,10,0,5,47
ASV5397,0,14,1,10,0,5,17,47
ASV5607,6,4,0,0,21,15,1,47
ASV6586,0,0,25,5,2,0,15,47
ASV6736,6,0,0,5,14,15,7,47
ASV6868,0,0,27,0,16,4,0,47
ASV7596,0,0,3,6,15,6,17,47
ASV7699,0,0,10,24,3,2,8,47
ASV7898,2,0,0,8,37,0,0,47
ASV8424,0,0,5,7,0,35,0,47
ASV9209,3,7,1,5,1,13,17,47
ASV9264,0,4,9,0,11,21,2,47
ASV9353,45,0,2,0,0,0,0,47
ASV10549,0,5,3,1,6,0,32,47
ASV11235,0,0,44,0,0,0,3,47
ASV11326,0,0,3,26,3,15,0,47
ASV11630,0,0,8,15,24,0,0,47
ASV12307,0,0,0,47,0,0,0,47
ASV12407,0,19,0,5,18,0,5,47
ASV13191,0,21,4,0,0,22,0,47
ASV13867,3,6,18,5,4,0,11,47
ASV14195,0,9,0,4,4,5,25,47
ASV15664,0,0,5,10,3,2,27,47
ASV16797,0,7,3,0,21,6,10,47
ASV17076,0,5,19,7,5,11,0,47
ASV17626,0,0,0,0,35,8,4,47
ASV17979,0,6,0,9,14,2,16,47
ASV18061,1,0,14,0,0,8,24,47
ASV18664,0,47,0,0,0,0,0,47
ASV19574,0,6,0,0,13,28,0,47
ASV20951,0,0,16,0,31,0,0,47
ASV494,0,0,0,23,7,10,6,46
ASV540,0,0,0,45,0,1,0,46
ASV634,0,0,27,0,0,4,15,46
ASV812,0,2,5,4,5,2,28,46
ASV1145,0,0,0,4,13,0,29,46
ASV2926,10,4,9,2,9,2,10,46
ASV4275,4,12,8,9,9,1,3,46
ASV4284,0,0,12,24,5,0,5,46
ASV4672,11,0,0,17,1,12,5,46
ASV4870,0,4,0,22,0,9,11,46
ASV5528,0,0,0,11,2,0,33,46
ASV6218,0,7,17,15,1,6,0,46
ASV6469,0,4,21,4,7,6,4,46
ASV6655,7,5,0,5,22,0,7,46
ASV7084,0,25,0,0,0,10,11,46
ASV7931,0,0,31,2,8,0,5,46
ASV8237,0,0,5,10,15,10,6,46
ASV8417,0,0,0,5,29,8,4,46
ASV8500,0,0,8,15,0,6,17,46
ASV9022,3,12,9,2,10,0,10,46
ASV9026,0,0,0,5,37,0,4,46
ASV9356,0,0,0,0,2,0,44,46
ASV9939,0,3,8,5,17,11,2,46
ASV10339,3,6,2,1,2,19,13,46
ASV11132,0,0,0,0,0,3,43,46
ASV11307,0,0,19,6,7,7,7,46
ASV12223,2,1,18,7,5,3,10,46
ASV12233,7,0,0,5,21,0,13,46
ASV12680,1,3,16,6,10,0,10,46
ASV12802,24,15,2,4,0,0,1,46
ASV12830,13,2,0,0,8,2,21,46
ASV13234,0,4,0,39,2,1,0,46
ASV13288,0,0,0,0,0,46,0,46
ASV13309,7,14,5,9,4,0,7,46
ASV13391,0,0,0,21,18,4,3,46
ASV13528,0,22,0,18,0,0,6,46
ASV13616,0,18,0,19,0,0,9,46
ASV13624,0,0,41,5,0,0,0,46
ASV15367,4,6,2,9,25,0,0,46
ASV15532,0,0,0,0,0,0,46,46
ASV15760,0,0,0,4,5,26,11,46
ASV16249,0,17,3,2,4,0,20,46
ASV17096,0,18,0,0,0,0,28,46
ASV17267,0,0,0,17,0,29,0,46
ASV17331,0,6,1,12,14,1,12,46
ASV18613,7,15,0,7,3,9,5,46
ASV19170,0,0,12,27,2,1,4,46
ASV21190,0,0,2,2,9,23,10,46
ASV21868,0,0,0,0,38,0,8,46
ASV21919,0,2,4,10,0,10,20,46
ASV22000,0,0,0,46,0,0,0,46
ASV22865,0,14,8,0,11,1,12,46
ASV23037,2,3,0,18,12,0,11,46
ASV2,6,0,7,5,11,12,4,45
ASV45,0,7,24,0,5,9,0,45
ASV171,0,18,7,12,0,0,8,45
ASV310,3,5,3,8,14,0,12,45
ASV434,0,2,14,19,0,3,7,45
ASV790,0,4,6,3,24,6,2,45
ASV877,2,6,0,2,18,13,4,45
ASV1608,0,1,21,5,0,4,14,45
ASV2015,3,1,0,4,5,18,14,45
ASV2178,0,0,11,4,23,5,2,45
ASV2484,0,2,13,24,1,0,5,45
ASV3251,0,0,13,21,7,4,0,45
ASV3572,0,0,4,17,10,14,0,45
ASV4351,4,2,16,9,4,9,1,45
ASV5452,0,0,10,10,8,15,2,45
ASV5884,0,0,0,45,0,0,0,45
ASV5907,0,0,11,19,2,13,0,45
ASV6012,0,0,4,2,9,14,16,45
ASV6046,15,23,0,0,7,0,0,45
ASV7240,0,0,45,0,0,0,0,45
ASV7837,12,8,5,9,5,2,4,45
ASV7865,0,2,20,0,4,14,5,45
ASV7878,0,0,20,0,0,11,14,45
ASV8439,0,0,15,0,1,7,22,45
ASV8458,0,7,5,6,17,8,2,45
ASV9105,0,0,11,11,3,2,18,45
ASV9171,3,0,4,7,8,3,20,45
ASV10002,0,10,5,10,2,15,3,45
ASV10189,0,6,25,11,3,0,0,45
ASV11193,0,0,18,19,0,0,8,45
ASV12103,0,0,0,0,12,23,10,45
ASV13972,0,2,17,8,5,0,13,45
ASV14168,0,11,13,8,8,3,2,45
ASV15148,0,27,2,1,9,2,4,45
ASV15331,0,0,14,11,1,17,2,45
ASV16169,0,0,0,45,0,0,0,45
ASV18555,0,6,0,17,5,11,6,45
ASV18741,0,0,12,23,0,0,10,45
ASV19982,0,3,12,8,2,20,0,45
ASV21366,0,0,0,45,0,0,0,45
ASV21439,4,0,35,5,1,0,0,45
ASV21538,0,0,18,0,0,27,0,45
ASV23323,1,0,10,5,5,0,24,45
ASV23463,0,0,0,45,0,0,0,45
ASV25982,0,0,27,13,0,5,0,45
ASV223,0,3,28,1,0,4,8,44
ASV300,0,28,0,6,0,10,0,44
ASV801,4,0,0,2,7,3,28,44
ASV889,0,0,1,33,6,1,3,44
ASV1040,0,5,0,0,9,2,28,44
ASV1480,1,13,1,9,6,0,14,44
ASV1568,5,0,17,15,0,5,2,44
ASV1593,0,0,26,1,10,7,0,44
ASV1601,0,0,5,6,3,0,30,44
ASV2113,1,40,1,2,0,0,0,44
ASV2271,0,0,20,10,13,0,1,44
ASV2346,0,1,9,13,0,16,5,44
ASV3122,0,0,2,20,3,13,6,44
ASV3335,0,0,14,12,5,0,13,44
ASV3473,0,6,0,13,7,5,13,44
ASV3646,16,0,0,7,21,0,0,44
ASV4397,3,0,10,18,0,13,0,44
ASV5013,0,3,5,16,2,4,14,44
ASV5513,0,26,2,1,3,4,8,44
ASV5737,13,0,6,0,3,14,8,44
ASV6678,0,0,8,4,13,13,6,44
ASV7531,0,39,0,0,0,5,0,44
ASV8380,0,13,8,13,8,1,1,44
ASV8401,0,9,0,12,0,0,23,44
ASV8574,0,12,0,20,12,0,0,44
ASV10078,25,0,18,0,0,0,1,44
ASV12025,0,10,0,20,6,0,8,44
ASV13182,1,12,30,0,1,0,0,44
ASV13961,0,0,0,0,44,0,0,44
ASV15729,0,13,12,7,0,1,11,44
ASV18320,5,7,6,3,23,0,0,44
ASV18652,10,0,3,0,26,0,5,44
ASV19551,0,0,0,24,6,0,14,44
ASV19957,7,0,11,7,0,15,4,44
ASV20275,12,15,0,11,0,0,6,44
ASV20612,0,0,0,0,0,0,44,44
ASV21574,0,0,0,34,10,0,0,44
ASV22715,0,5,0,23,7,0,9,44
ASV22860,0,3,0,4,26,8,3,44
ASV24426,0,0,0,0,0,0,44,44
ASV27166,0,0,9,0,23,0,12,44
ASV119,0,0,0,0,0,11,32,43
ASV297,11,1,3,2,17,9,0,43
ASV609,1,3,17,6,2,12,2,43
ASV1160,4,24,4,0,4,0,7,43
ASV1355,0,1,5,8,9,9,11,43
ASV1361,0,2,14,4,17,4,2,43
ASV1490,14,0,6,6,0,11,6,43
ASV1941,0,0,3,6,7,0,27,43
ASV2147,10,0,2,20,5,0,6,43
ASV2473,0,4,12,0,0,6,21,43
ASV2707,0,17,14,1,2,6,3,43
ASV2730,0,2,19,7,8,7,0,43
ASV3323,0,2,0,10,13,18,0,43
ASV3636,3,4,8,4,1,18,5,43
ASV4475,11,0,0,9,23,0,0,43
ASV4516,0,8,1,0,12,20,2,43
ASV4707,0,0,9,0,11,20,3,43
ASV4968,11,0,0,0,0,32,0,43
ASV5284,0,8,8,13,7,5,2,43
ASV5510,0,0,20,5,8,9,1,43
ASV6838,0,0,0,3,32,8,0,43
ASV6992,0,0,13,12,10,0,8,43
ASV7173,1,1,8,25,8,0,0,43
ASV7576,0,0,7,0,14,11,11,43
ASV7934,0,0,0,0,5,24,14,43
ASV8639,0,5,0,16,8,0,14,43
ASV9368,0,0,0,23,0,5,15,43
ASV10053,0,4,4,6,21,6,2,43
ASV10335,25,0,0,0,11,7,0,43
ASV10418,0,0,0,43,0,0,0,43
ASV10536,0,0,14,0,0,29,0,43
ASV11024,0,0,0,0,22,0,21,43
ASV12946,0,0,9,14,3,12,5,43
ASV13334,0,15,4,6,13,1,4,43
ASV14138,5,0,6,3,22,0,7,43
ASV14750,0,3,0,13,9,0,18,43
ASV16705,0,2,24,5,1,7,4,43
ASV17262,17,16,9,0,0,1,0,43
ASV17882,4,4,5,8,2,8,12,43
ASV18388,0,0,5,10,0,28,0,43
ASV18642,0,0,1,15,2,10,15,43
ASV19001,0,0,18,2,0,23,0,43
ASV21150,7,0,5,0,0,31,0,43
ASV24664,0,35,0,8,0,0,0,43
ASV26138,0,0,0,42,0,1,0,43
ASV12,0,5,0,19,9,5,4,42
ASV249,2,4,24,12,0,0,0,42
ASV952,6,13,0,18,0,2,3,42
ASV1218,0,2,17,3,16,3,1,42
ASV1840,0,15,0,4,5,11,7,42
ASV2522,9,4,11,2,2,3,11,42
ASV2835,0,4,20,1,10,7,0,42
ASV3028,11,1,2,8,15,5,0,42
ASV3924,0,5,14,1,10,10,2,42
ASV5275,0,5,5,18,0,0,14,42
ASV5656,10,10,5,8,9,0,0,42
ASV6178,0,0,0,4,21,0,17,42
ASV6332,0,0,1,25,13,0,3,42
ASV7007,0,0,15,9,0,0,18,42
ASV7075,0,8,1,14,7,5,7,42
ASV7442,15,3,17,2,0,0,5,42
ASV8486,0,38,0,0,0,4,0,42
ASV9931,7,0,2,18,11,0,4,42
ASV10154,0,0,0,42,0,0,0,42
ASV11249,2,0,16,13,1,0,10,42
ASV11533,0,8,12,0,0,22,0,42
ASV11774,23,0,0,0,8,9,2,42
ASV12043,0,26,3,0,0,13,0,42
ASV12186,3,19,0,0,18,0,2,42
ASV12597,0,4,3,3,4,10,18,42
ASV13244,0,2,4,8,0,15,13,42
ASV13768,0,9,13,0,5,11,4,42
ASV13861,0,0,0,29,0,13,0,42
ASV14028,6,5,0,7,8,1,15,42
ASV14290,0,3,0,3,36,0,0,42
ASV14403,0,0,0,42,0,0,0,42
ASV14757,3,8,9,2,12,0,8,42
ASV15045,42,0,0,0,0,0,0,42
ASV16847,0,14,25,3,0,0,0,42
ASV17008,0,0,5,0,0,0,37,42
ASV19348,0,0,1,0,30,3,8,42
ASV22043,0,0,20,0,0,11,11,42
ASV22086,0,0,0,10,0,0,32,42
ASV22764,0,42,0,0,0,0,0,42
ASV23155,2,0,0,12,3,0,25,42
ASV24840,0,0,0,14,7,11,10,42
ASV25509,0,0,2,12,2,5,21,42
ASV26990,0,0,0,7,10,0,25,42
ASV112,0,0,5,3,3,17,13,41
ASV279,10,0,7,8,13,1,2,41
ASV354,0,6,9,1,7,10,8,41
ASV438,0,3,11,5,6,8,8,41
ASV981,2,0,4,22,4,0,9,41
ASV2013,0,3,0,0,0,21,17,41
ASV3374,4,1,16,16,0,1,3,41
ASV3700,0,5,7,1,7,7,14,41
ASV3717,0,0,9,16,0,16,0,41
ASV4652,0,0,2,0,8,6,25,41
ASV4690,0,0,11,14,3,13,0,41
ASV4890,0,0,22,2,4,1,12,41
ASV5126,2,4,3,13,19,0,0,41
ASV7098,0,5,0,22,5,0,9,41
ASV7522,0,0,18,9,5,9,0,41
ASV8046,0,32,9,0,0,0,0,41
ASV8804,0,2,19,0,7,13,0,41
ASV9079,19,0,19,0,0,3,0,41
ASV10463,0,0,14,6,3,15,3,41
ASV10757,0,21,0,20,0,0,0,41
ASV11399,14,2,0,0,19,6,0,41
ASV11613,0,3,9,0,0,0,29,41
ASV12637,17,6,0,3,7,0,8,41
ASV13016,0,3,0,12,12,0,14,41
ASV13203,25,0,1,15,0,0,0,41
ASV13481,8,1,1,0,7,5,19,41
ASV14778,4,0,15,5,0,16,1,41
ASV15794,3,9,13,1,1,8,6,41
ASV16176,0,19,0,4,18,0,0,41
ASV16256,0,7,21,0,0,6,7,41
ASV16815,6,0,0,0,13,0,22,41
ASV17033,0,0,41,0,0,0,0,41
ASV17210,0,1,0,0,3,0,37,41
ASV18023,0,7,19,1,0,14,0,41
ASV19929,0,0,28,0,9,4,0,41
ASV20335,0,0,14,20,0,0,7,41
ASV20857,3,8,7,6,4,5,8,41
ASV21438,13,28,0,0,0,0,0,41
ASV22931,0,3,10,0,17,0,11,41
ASV24939,0,18,6,0,0,17,0,41
ASV26089,0,3,10,11,0,0,17,41
ASV26502,0,1,17,0,12,0,11,41
ASV262,0,10,0,1,2,24,3,40
ASV475,4,0,7,5,13,9,2,40
ASV697,0,2,6,4,2,26,0,40
ASV827,0,7,9,3,9,3,9,40
ASV905,0,4,4,0,13,19,0,40
ASV1172,0,1,7,22,8,1,1,40
ASV1297,0,0,8,32,0,0,0,40
ASV1773,0,0,0,32,0,8,0,40
ASV2170,1,10,4,15,8,2,0,40
ASV2536,0,2,6,0,32,0,0,40
ASV2623,12,11,4,0,0,2,11,40
ASV3062,14,0,11,0,6,3,6,40
ASV3262,3,1,0,5,0,0,31,40
ASV4105,9,7,6,5,2,0,11,40
ASV4196,0,3,4,5,0,3,25,40
ASV4504,2,0,12,26,0,0,0,40
ASV4525,1,23,1,0,0,14,1,40
ASV5524,0,0,8,8,4,6,14,40
ASV5675,4,0,34,0,2,0,0,40
ASV5689,0,13,8,1,12,0,6,40
ASV6053,0,0,6,3,31,0,0,40
ASV6460,0,0,7,16,7,8,2,40
ASV6591,9,0,4,3,0,24,0,40
ASV7297,0,0,0,22,2,2,14,40
ASV7834,1,0,15,8,3,7,6,40
ASV7847,0,21,16,0,0,0,3,40
ASV8684,1,2,4,2,2,22,7,40
ASV8994,0,0,0,13,0,4,23,40
ASV9315,0,6,4,5,13,5,7,40
ASV9578,0,0,20,0,18,0,2,40
ASV10085,0,0,10,15,9,3,3,40
ASV10606,0,12,4,8,6,10,0,40
ASV11317,4,2,6,13,4,6,5,40
ASV11358,0,0,0,0,19,0,21,40
ASV11377,1,0,32,7,0,0,0,40
ASV11567,8,7,6,9,5,4,1,40
ASV12007,4,0,0,15,11,0,10,40
ASV12784,0,3,17,1,0,17,2,40
ASV12876,0,32,2,6,0,0,0,40
ASV12960,5,3,8,4,0,20,0,40
ASV13860,0,1,29,0,1,7,2,40
ASV13912,1,17,0,0,3,19,0,40
ASV14049,0,0,4,0,13,18,5,40
ASV14426,0,2,7,7,3,10,11,40
ASV15471,2,10,9,1,4,1,13,40
ASV15521,1,5,11,14,3,6,0,40
ASV16079,0,0,0,0,0,40,0,40
ASV16244,0,5,0,0,0,0,35,40
ASV16390,0,0,8,0,12,20,0,40
ASV17238,4,6,11,2,15,1,1,40
ASV17358,2,0,5,0,0,14,19,40
ASV18740,0,0,0,0,17,17,6,40
ASV18903,3,3,0,11,12,3,8,40
ASV19372,5,0,5,0,1,0,29,40
ASV19431,12,4,5,11,8,0,0,40
ASV19512,9,1,0,11,19,0,0,40
ASV19860,7,17,4,4,4,0,4,40
ASV20827,3,13,2,2,0,0,20,40
ASV22029,0,0,4,15,14,0,7,40
ASV754,5,0,0,0,11,4,19,39
ASV760,0,16,12,5,5,1,0,39
ASV781,0,2,16,8,4,2,7,39
ASV977,0,0,19,1,0,19,0,39
ASV1048,0,1,0,0,10,12,16,39
ASV1060,0,0,0,11,25,1,2,39
ASV1128,2,1,5,17,0,0,14,39
ASV1249,0,0,7,17,1,4,10,39
ASV1351,0,0,6,13,0,5,15,39
ASV1830,0,2,4,10,3,0,20,39
ASV2260,0,0,0,2,5,0,32,39
ASV2712,8,7,1,18,5,0,0,39
ASV5341,0,0,2,17,11,6,3,39
ASV5621,2,0,23,8,0,3,3,39
ASV5796,9,13,0,0,6,11,0,39
ASV5999,3,0,8,3,0,7,18,39
ASV6009,9,0,9,8,5,4,4,39
ASV6737,0,0,9,17,6,0,7,39
ASV6819,0,7,14,7,0,5,6,39
ASV7337,1,0,0,28,9,0,1,39
ASV7771,30,0,5,4,0,0,0,39
ASV7854,0,9,14,0,0,8,8,39
ASV8057,0,3,15,3,6,0,12,39
ASV8357,0,4,0,1,11,3,20,39
ASV9363,0,0,0,7,11,0,21,39
ASV9590,2,0,29,0,3,5,0,39
ASV9703,3,14,0,11,4,0,7,39
ASV9953,0,0,0,39,0,0,0,39
ASV10181,0,0,0,19,20,0,0,39
ASV10454,0,2,3,4,3,11,16,39
ASV10680,0,13,3,4,13,6,0,39
ASV10864,0,0,0,0,39,0,0,39
ASV13173,0,0,0,12,14,6,7,39
ASV13226,4,0,10,9,4,6,6,39
ASV13569,27,4,0,7,0,0,1,39
ASV14749,0,0,16,7,3,5,8,39
ASV15313,0,0,0,0,39,0,0,39
ASV15646,5,9,6,7,8,0,4,39
ASV16632,1,0,0,8,22,1,7,39
ASV17058,0,0,0,7,16,0,16,39
ASV17564,0,0,5,3,0,31,0,39
ASV19433,0,3,5,6,17,4,4,39
ASV20307,2,0,7,17,0,0,13,39
ASV20419,0,1,6,3,13,15,1,39
ASV20525,0,0,6,0,0,33,0,39
ASV21170,4,0,20,7,0,8,0,39
ASV22351,0,13,4,13,0,9,0,39
ASV22482,1,0,0,3,18,0,17,39
ASV22524,0,2,8,5,11,4,9,39
ASV23626,0,0,0,3,0,2,34,39
ASV24650,0,0,0,24,0,2,13,39
ASV25324,8,30,0,1,0,0,0,39
ASV26758,0,0,0,0,39,0,0,39
ASV1609,0,34,0,0,4,0,0,38
ASV1948,0,0,4,0,15,3,16,38
ASV2165,0,1,0,0,25,8,4,38
ASV2686,0,7,4,8,8,11,0,38
ASV2727,0,0,9,6,8,6,9,38
ASV2952,0,0,3,3,1,3,28,38
ASV2979,0,0,0,6,0,30,2,38
ASV3685,0,0,0,0,25,12,1,38
ASV3696,0,0,0,20,12,0,6,38
ASV4460,0,0,14,4,11,7,2,38
ASV4730,13,14,0,0,0,11,0,38
ASV4821,0,0,0,2,36,0,0,38
ASV5376,0,0,0,7,20,0,11,38
ASV5564,0,0,0,36,0,2,0,38
ASV5625,3,6,5,7,10,3,4,38
ASV5889,0,0,0,5,21,0,12,38
ASV6157,6,1,8,10,6,0,7,38
ASV6400,0,2,3,0,2,1,30,38
ASV7643,14,0,6,6,0,0,12,38
ASV7694,0,1,14,0,7,12,4,38
ASV7754,0,33,0,0,0,0,5,38
ASV7825,3,4,6,5,8,0,12,38
ASV8624,0,6,3,2,15,3,9,38
ASV8765,0,11,1,0,0,26,0,38
ASV8815,0,2,10,11,3,11,1,38
ASV8965,0,6,3,0,15,6,8,38
ASV9136,0,4,13,0,0,21,0,38
ASV9532,0,0,6,21,6,5,0,38
ASV9622,15,5,10,2,1,0,5,38
ASV9925,0,4,7,0,9,18,0,38
ASV10483,3,0,5,9,11,9,1,38
ASV11413,5,12,0,3,6,4,8,38
ASV11503,0,0,0,0,14,0,24,38
ASV12129,0,0,4,0,28,0,6,38
ASV12255,12,0,0,0,26,0,0,38
ASV12971,0,3,5,14,1,15,0,38
ASV12990,3,0,9,4,9,13,0,38
ASV13594,0,0,29,0,6,0,3,38
ASV15300,0,0,4,29,5,0,0,38
ASV16308,0,8,6,10,7,2,5,38
ASV16904,4,4,0,0,12,18,0,38
ASV17200,0,0,0,18,13,6,1,38
ASV17732,0,38,0,0,0,0,0,38
ASV18206,0,0,0,0,0,0,38,38
ASV20846,15,0,0,23,0,0,0,38
ASV21021,0,9,6,12,0,11,0,38
ASV25,0,0,14,0,12,6,5,37
ASV91,11,0,5,5,3,9,4,37
ASV490,0,0,0,2,20,0,15,37
ASV598,8,7,2,16,2,2,0,37
ASV990,0,0,6,5,9,14,3,37
ASV1062,0,0,0,0,0,37,0,37
ASV1124,0,6,3,0,5,7,16,37
ASV1488,0,0,0,5,0,32,0,37
ASV2240,0,0,0,18,3,6,10,37
ASV2419,0,6,3,0,6,14,8,37
ASV2894,0,18,0,9,7,0,3,37
ASV3129,0,12,0,0,10,0,15,37
ASV3165,5,14,0,0,0,13,5,37
ASV3256,0,0,0,0,0,29,8,37
ASV4848,11,5,1,9,5,0,6,37
ASV7346,0,5,11,14,0,0,7,37
ASV7541,7,11,0,13,0,0,6,37
ASV7578,8,0,0,27,0,2,0,37
ASV7659,0,0,24,0,0,10,3,37
ASV7709,2,10,0,9,5,7,4,37
ASV7826,0,0,13,11,4,0,9,37
ASV8162,0,0,0,2,8,4,23,37
ASV8245,0,0,9,3,23,0,2,37
ASV10028,0,13,3,6,5,0,10,37
ASV10119,0,0,12,4,6,15,0,37
ASV10738,0,30,1,6,0,0,0,37
ASV11292,0,27,10,0,0,0,0,37
ASV11300,5,0,6,15,0,4,7,37
ASV11626,0,3,6,4,16,0,8,37
ASV11670,7,0,1,5,2,7,15,37
ASV12260,0,0,8,11,0,6,12,37
ASV12812,2,35,0,0,0,0,0,37
ASV12850,11,12,0,0,5,3,6,37
ASV15224,0,0,0,13,11,0,13,37
ASV15248,0,8,0,1,7,13,8,37
ASV15865,2,9,6,4,1,13,2,37
ASV16105,0,0,0,0,2,0,35,37
ASV16543,0,0,29,0,0,8,0,37
ASV16591,0,0,8,6,6,3,14,37
ASV16952,0,0,10,16,0,4,7,37
ASV17242,0,9,1,0,5,15,7,37
ASV18623,3,2,5,12,10,0,5,37
ASV20069,0,16,0,5,0,0,16,37
ASV20515,0,0,0,0,37,0,0,37
ASV21062,2,0,1,21,8,0,5,37
ASV22033,0,6,9,0,9,13,0,37
ASV22102,0,0,25,0,5,7,0,37
ASV22129,0,5,2,13,4,0,13,37
ASV22231,0,0,0,0,22,0,15,37
ASV22275,0,0,10,12,2,6,7,37
ASV22737,0,0,0,8,4,20,5,37
ASV23742,0,0,0,5,22,1,9,37
ASV24166,0,24,5,0,0,8,0,37
ASV25835,0,1,10,2,24,0,0,37
ASV25929,14,0,0,11,5,0,7,37
ASV26444,0,10,15,3,1,5,3,37
ASV26727,3,7,4,3,9,11,0,37
ASV933,0,5,6,3,8,3,11,36
ASV1038,0,0,8,13,6,9,0,36
ASV1940,0,0,1,5,3,0,27,36
ASV2011,15,0,0,10,11,0,0,36
ASV2320,0,0,4,2,29,0,1,36
ASV2616,0,0,6,22,0,1,7,36
ASV2889,0,1,2,0,23,0,10,36
ASV3015,0,5,2,3,5,6,15,36
ASV3529,21,4,2,2,2,0,5,36
ASV3560,0,0,0,0,28,7,1,36
ASV3773,0,0,12,2,22,0,0,36
ASV4008,0,0,6,18,0,7,5,36
ASV4053,0,2,9,11,10,0,4,36
ASV4251,0,0,25,11,0,0,0,36
ASV4618,0,0,3,2,11,6,14,36
ASV4770,0,19,8,5,0,0,4,36
ASV5571,0,0,4,3,1,27,1,36
ASV5665,0,1,2,2,18,7,6,36
ASV5691,8,0,8,0,20,0,0,36
ASV5747,7,6,6,0,7,0,10,36
ASV6568,0,5,14,1,6,1,9,36
ASV6688,0,6,3,0,0,23,4,36
ASV6690,0,0,0,0,2,0,34,36
ASV6923,0,0,0,3,8,3,22,36
ASV7091,3,3,11,6,0,8,5,36
ASV7139,0,1,16,1,6,0,12,36
ASV7348,0,7,9,3,2,11,4,36
ASV7599,0,8,6,5,5,7,5,36
ASV7714,0,0,0,0,11,5,20,36
ASV7819,0,3,3,1,0,4,25,36
ASV7901,15,0,2,19,0,0,0,36
ASV7949,0,1,23,7,0,0,5,36
ASV7984,0,0,3,8,18,0,7,36
ASV8200,0,6,7,6,14,0,3,36
ASV8329,0,0,0,0,0,0,36,36
ASV8446,36,0,0,0,0,0,0,36
ASV8755,0,6,0,9,5,4,12,36
ASV8967,0,4,11,0,5,5,11,36
ASV9030,0,0,11,3,18,0,4,36
ASV10608,0,1,12,11,6,6,0,36
ASV10733,0,0,1,0,0,9,26,36
ASV10984,0,0,0,36,0,0,0,36
ASV11224,4,0,0,2,8,22,0,36
ASV11979,0,1,16,8,0,0,11,36
ASV12491,13,1,2,3,2,5,10,36
ASV12501,4,0,9,11,3,2,7,36
ASV13233,0,0,5,0,31,0,0,36
ASV13303,0,0,8,0,28,0,0,36
ASV15073,0,0,2,17,1,11,5,36
ASV15465,0,1,0,2,0,9,24,36
ASV15877,0,21,15,0,0,0,0,36
ASV15906,4,7,15,2,2,6,0,36
ASV16210,0,15,0,0,0,0,21,36
ASV16219,0,0,4,25,3,0,4,36
ASV16636,0,1,6,5,0,0,24,36
ASV17473,9,0,8,10,4,0,5,36
ASV18213,0,0,36,0,0,0,0,36
ASV22721,2,0,6,9,5,10,4,36
ASV25454,0,7,0,23,2,0,4,36
ASV27164,0,5,0,19,4,0,8,36
ASV355,2,0,14,3,6,9,1,35
ASV961,4,0,10,7,1,0,13,35
ASV1233,0,7,4,3,0,1,20,35
ASV1454,2,18,5,0,0,10,0,35
ASV1598,5,1,3,0,5,17,4,35
ASV1627,0,0,6,3,26,0,0,35
ASV2189,5,0,0,10,10,0,10,35
ASV2343,5,0,25,0,5,0,0,35
ASV2356,2,11,0,5,7,3,7,35
ASV2423,0,0,2,6,22,0,5,35
ASV2572,0,0,0,0,2,33,0,35
ASV2749,0,0,7,3,13,12,0,35
ASV2930,1,1,4,14,2,1,12,35
ASV3235,0,0,9,17,9,0,0,35
ASV3667,11,0,0,22,1,0,1,35
ASV4121,0,0,0,11,0,0,24,35
ASV4267,0,5,2,24,0,0,4,35
ASV4479,0,0,15,11,5,0,4,35
ASV4779,12,0,0,11,0,3,9,35
ASV4876,4,7,5,2,6,3,8,35
ASV5478,0,5,2,3,18,5,2,35
ASV5489,0,0,5,28,2,0,0,35
ASV6036,0,0,14,0,17,4,0,35
ASV6043,2,0,7,2,5,14,5,35
ASV6331,0,5,3,6,3,14,4,35
ASV6424,0,0,0,0,0,0,35,35
ASV7005,0,8,14,0,2,0,11,35
ASV7294,0,25,4,5,1,0,0,35
ASV7375,0,1,5,4,4,10,11,35
ASV7573,0,0,4,9,0,16,6,35
ASV7836,0,0,1,0,3,4,27,35
ASV7933,0,0,0,0,35,0,0,35
ASV8588,0,0,3,19,0,0,13,35
ASV10179,0,0,7,3,0,5,20,35
ASV10592,0,0,4,28,3,0,0,35
ASV10709,0,0,33,0,0,2,0,35
ASV10896,0,0,35,0,0,0,0,35
ASV11071,0,0,7,14,0,5,9,35
ASV11387,0,0,0,35,0,0,0,35
ASV12021,0,0,8,2,17,8,0,35
ASV13352,0,0,0,35,0,0,0,35
ASV13365,27,0,0,0,8,0,0,35
ASV13675,1,2,3,6,10,5,8,35
ASV14078,4,1,0,8,21,0,1,35
ASV15057,0,0,3,12,2,3,15,35
ASV15907,0,0,2,3,9,1,20,35
ASV17089,0,0,35,0,0,0,0,35
ASV17815,0,0,8,27,0,0,0,35
ASV17901,0,0,6,0,11,0,18,35
ASV19770,0,0,3,7,0,25,0,35
ASV19897,0,7,7,16,0,5,0,35
ASV20152,0,0,28,0,0,0,7,35
ASV21114,0,0,11,16,1,0,7,35
ASV22134,0,0,0,20,0,11,4,35
ASV23106,1,0,33,0,0,1,0,35
ASV23705,0,0,12,7,4,5,7,35
ASV251,0,20,0,2,0,9,3,34
ASV476,0,0,0,0,0,23,11,34
ASV605,0,3,8,0,11,12,0,34
ASV698,5,5,0,7,1,0,16,34
ASV1680,0,0,6,1,3,13,11,34
ASV1709,0,0,3,8,10,0,13,34
ASV2325,0,0,4,7,0,11,12,34
ASV2472,20,5,0,5,0,0,4,34
ASV2870,2,1,0,11,4,0,16,34
ASV2958,0,9,7,10,6,2,0,34
ASV3090,0,1,0,5,6,0,22,34
ASV3824,0,0,8,0,0,26,0,34
ASV3950,0,6,12,4,5,4,3,34
ASV4066,0,0,11,2,0,21,0,34
ASV4168,3,0,11,13,6,0,1,34
ASV4294,0,0,17,11,2,4,0,34
ASV4604,4,0,7,2,2,6,13,34
ASV4615,0,0,0,34,0,0,0,34
ASV5180,3,9,7,7,8,0,0,34
ASV5686,0,0,4,3,0,17,10,34
ASV5868,0,3,0,0,31,0,0,34
ASV6291,0,0,22,0,8,0,4,34
ASV6397,0,0,0,0,2,18,14,34
ASV6752,0,0,23,3,8,0,0,34
ASV7435,4,6,0,8,13,0,3,34
ASV7959,0,19,0,0,15,0,0,34
ASV9433,0,0,0,27,0,0,7,34
ASV9484,0,0,0,0,0,34,0,34
ASV9502,0,1,10,8,15,0,0,34
ASV9743,0,0,0,25,0,9,0,34
ASV11426,0,0,22,0,0,12,0,34
ASV11559,7,14,0,13,0,0,0,34
ASV11840,0,0,3,2,5,16,8,34
ASV12123,0,10,0,1,0,23,0,34
ASV12777,0,6,17,0,0,3,8,34
ASV13335,0,0,1,0,1,6,26,34
ASV13689,0,0,18,5,11,0,0,34
ASV13942,0,19,0,15,0,0,0,34
ASV13951,0,4,8,6,13,0,3,34
ASV15209,0,0,2,0,0,25,7,34
ASV15307,0,27,0,0,0,0,7,34
ASV15356,0,0,9,16,0,9,0,34
ASV15588,0,9,6,0,1,11,7,34
ASV15700,6,0,4,0,0,17,7,34
ASV16523,0,0,1,0,7,0,26,34
ASV16801,0,0,2,0,32,0,0,34
ASV19548,3,9,3,3,12,0,4,34
ASV21253,0,25,1,0,8,0,0,34
ASV21360,0,34,0,0,0,0,0,34
ASV21716,6,0,0,14,0,14,0,34
ASV22545,0,21,0,0,1,10,2,34
ASV22967,0,0,18,5,4,4,3,34
ASV23017,0,0,23,0,0,11,0,34
ASV23246,0,0,6,0,28,0,0,34
ASV23414,0,19,0,5,0,10,0,34
ASV24814,0,0,0,1,7,0,26,34
ASV26104,0,0,3,29,2,0,0,34
ASV146,0,2,0,0,4,3,24,33
ASV234,0,8,7,0,2,15,1,33
ASV293,7,10,7,6,0,3,0,33
ASV729,4,0,11,0,10,8,0,33
ASV844,0,9,13,0,11,0,0,33
ASV887,0,3,2,0,2,3,23,33
ASV1004,0,9,0,2,0,0,22,33
ASV1105,0,8,21,0,0,2,2,33
ASV2494,0,7,4,1,5,6,10,33
ASV2635,0,4,2,11,7,3,6,33
ASV3036,0,2,6,8,4,11,2,33
ASV3277,33,0,0,0,0,0,0,33
ASV3617,0,0,0,0,33,0,0,33
ASV3704,0,0,0,0,10,5,18,33
ASV4225,3,1,0,6,8,0,15,33
ASV4581,0,0,12,6,7,7,1,33
ASV4590,0,5,3,3,0,2,20,33
ASV4900,0,6,5,8,0,6,8,33
ASV5003,0,0,6,0,12,0,15,33
ASV5256,0,1,12,10,10,0,0,33
ASV5315,0,9,1,0,23,0,0,33
ASV5479,2,0,0,16,13,0,2,33
ASV5705,0,3,13,8,0,0,9,33
ASV5778,0,24,0,7,0,0,2,33
ASV6048,0,8,4,3,4,4,10,33
ASV6715,0,0,0,6,12,0,15,33
ASV7205,10,2,9,2,4,1,5,33
ASV7881,3,0,6,17,7,0,0,33
ASV8121,0,0,3,0,0,14,16,33
ASV8695,33,0,0,0,0,0,0,33
ASV9687,0,0,0,0,31,0,2,33
ASV9899,0,0,0,0,33,0,0,33
ASV10482,0,0,5,27,0,0,1,33
ASV10499,0,3,9,3,5,10,3,33
ASV10837,1,6,2,4,1,2,17,33
ASV11731,0,0,0,3,0,8,22,33
ASV11904,2,5,5,4,3,0,14,33
ASV11927,0,0,2,0,31,0,0,33
ASV11934,0,13,5,6,0,6,3,33
ASV11936,0,8,3,10,0,6,6,33
ASV11969,0,0,4,4,13,12,0,33
ASV12477,0,0,3,6,24,0,0,33
ASV13710,0,0,6,15,1,0,11,33
ASV13933,0,0,0,0,20,4,9,33
ASV14003,0,0,0,33,0,0,0,33
ASV15492,0,0,0,6,1,0,26,33
ASV15821,0,0,9,4,10,5,5,33
ASV16604,0,0,0,33,0,0,0,33
ASV17709,0,0,0,0,14,0,19,33
ASV17974,1,0,5,0,0,11,16,33
ASV18078,0,5,16,3,4,5,0,33
ASV18690,0,0,0,5,26,0,2,33
ASV18793,0,0,4,8,3,7,11,33
ASV19599,0,6,0,0,0,0,27,33
ASV19904,7,3,15,2,2,3,1,33
ASV20273,0,0,0,11,4,10,8,33
ASV20359,0,0,8,10,1,11,3,33
ASV22199,0,10,0,4,19,0,0,33
ASV22251,0,7,14,0,0,5,7,33
ASV22656,0,6,15,0,3,0,9,33
ASV22857,0,9,7,0,0,6,11,33
ASV23302,0,2,0,17,0,0,14,33
ASV23875,0,0,0,11,0,4,18,33
ASV38,0,30,0,0,0,0,2,32
ASV40,0,0,16,0,7,9,0,32
ASV87,3,11,7,4,3,3,1,32
ASV90,0,4,14,6,0,2,6,32
ASV238,4,5,2,18,1,2,0,32
ASV318,0,0,0,0,1,2,29,32
ASV496,3,5,5,1,14,4,0,32
ASV533,0,0,12,11,3,2,4,32
ASV1682,0,6,2,12,10,2,0,32
ASV2338,0,0,12,2,1,5,12,32
ASV2878,2,0,5,0,8,8,9,32
ASV3356,0,4,6,0,12,0,10,32
ASV3359,0,7,1,19,0,5,0,32
ASV3703,0,0,24,0,3,5,0,32
ASV3869,14,0,0,3,3,11,1,32
ASV3905,0,0,0,0,0,0,32,32
ASV4006,0,0,1,31,0,0,0,32
ASV4937,0,0,32,0,0,0,0,32
ASV4966,19,2,0,4,5,0,2,32
ASV4972,9,9,0,4,0,10,0,32
ASV5037,3,0,1,10,14,0,4,32
ASV5569,0,12,0,2,0,15,3,32
ASV5587,3,3,12,0,1,13,0,32
ASV6281,0,0,0,21,11,0,0,32
ASV6382,0,2,10,0,6,14,0,32
ASV6795,0,2,4,11,0,7,8,32
ASV7055,0,0,0,0,0,0,32,32
ASV7142,20,3,9,0,0,0,0,32
ASV7189,0,0,3,6,3,8,12,32
ASV7630,1,3,17,0,0,7,4,32
ASV7746,0,8,6,0,0,0,18,32
ASV7805,0,0,0,22,0,0,10,32
ASV7885,0,3,5,0,15,9,0,32
ASV7945,0,0,9,11,0,12,0,32
ASV8187,0,0,5,12,12,0,3,32
ASV8524,0,0,13,11,8,0,0,32
ASV8635,0,0,4,5,5,0,18,32
ASV9159,0,0,9,9,4,10,0,32
ASV9444,0,0,3,3,12,11,3,32
ASV9908,11,8,7,0,0,4,2,32
ASV10159,9,3,5,6,2,7,0,32
ASV10265,0,7,3,4,4,5,9,32
ASV10535,0,0,5,3,10,12,2,32
ASV10612,0,0,1,4,5,17,5,32
ASV11015,0,0,3,0,0,22,7,32
ASV11216,0,6,0,10,12,4,0,32
ASV11807,0,6,0,15,3,0,8,32
ASV11981,0,3,5,0,0,18,6,32
ASV12440,0,1,0,0,7,11,13,32
ASV13188,0,0,0,0,0,0,32,32
ASV13297,0,0,1,0,31,0,0,32
ASV13614,0,1,8,8,1,4,10,32
ASV13698,0,0,17,0,1,3,11,32
ASV13712,5,1,0,0,2,18,6,32
ASV13925,17,0,0,3,0,0,12,32
ASV14923,0,0,22,0,10,0,0,32
ASV15695,0,0,4,2,19,0,7,32
ASV16629,0,0,0,32,0,0,0,32
ASV16652,0,0,0,29,3,0,0,32
ASV16848,0,2,17,5,8,0,0,32
ASV17343,0,0,0,2,27,0,3,32
ASV17491,0,0,12,0,1,14,5,32
ASV17733,1,0,0,1,16,0,14,32
ASV18268,0,10,15,7,0,0,0,32
ASV19478,0,0,14,1,17,0,0,32
ASV19679,13,0,5,12,0,0,2,32
ASV19914,0,0,0,0,0,8,24,32
ASV22273,4,0,1,0,0,12,15,32
ASV25403,0,4,0,13,8,0,7,32
ASV387,2,8,6,0,0,0,15,31
ASV525,0,9,0,0,12,9,1,31
ASV630,0,7,11,0,12,1,0,31
ASV851,2,18,0,0,7,0,4,31
ASV1115,0,0,16,0,0,15,0,31
ASV1368,0,0,28,0,0,0,3,31
ASV2846,0,0,6,4,0,1,20,31
ASV2932,0,0,0,6,3,22,0,31
ASV3225,0,0,2,20,5,0,4,31
ASV3486,3,0,0,3,13,0,12,31
ASV4070,1,0,12,0,4,4,10,31
ASV4077,0,0,21,1,2,7,0,31
ASV4417,0,0,10,2,19,0,0,31
ASV4450,0,6,2,22,0,0,1,31
ASV4722,0,1,0,9,0,15,6,31
ASV4747,0,15,5,0,0,11,0,31
ASV4923,0,0,0,14,17,0,0,31
ASV5287,0,0,12,0,0,17,2,31
ASV5362,0,0,2,0,19,10,0,31
ASV6001,6,22,0,0,0,0,3,31
ASV6522,8,0,0,0,9,0,14,31
ASV6536,0,13,0,2,0,0,16,31
ASV6805,0,0,0,0,0,2,29,31
ASV6939,0,6,1,3,6,0,15,31
ASV7162,3,4,2,6,3,1,12,31
ASV7461,0,0,20,7,0,0,4,31
ASV7657,0,8,9,1,0,2,11,31
ASV7948,1,12,0,0,8,1,9,31
ASV7978,0,0,1,2,8,3,17,31
ASV8148,0,4,0,11,16,0,0,31
ASV8406,3,0,0,21,2,0,5,31
ASV8427,0,0,2,0,0,29,0,31
ASV8723,1,0,0,15,5,0,10,31
ASV8830,14,4,0,0,5,0,8,31
ASV8897,0,0,1,2,9,6,13,31
ASV9227,0,5,13,5,0,8,0,31
ASV9650,0,1,4,11,0,5,10,31
ASV9865,5,0,16,0,6,0,4,31
ASV9877,0,8,0,21,0,0,2,31
ASV10144,0,0,0,18,0,0,13,31
ASV10458,21,0,4,6,0,0,0,31
ASV11141,0,0,0,0,31,0,0,31
ASV11453,0,0,0,0,0,0,31,31
ASV12518,0,0,26,0,5,0,0,31
ASV13122,0,3,8,4,11,2,3,31
ASV13433,3,0,0,3,0,0,25,31
ASV14082,0,0,0,0,31,0,0,31
ASV14588,0,0,12,7,0,4,8,31
ASV15297,0,0,0,11,15,4,1,31
ASV15798,0,6,0,7,9,3,6,31
ASV16483,0,3,2,19,3,0,4,31
ASV16715,0,0,0,0,14,0,17,31
ASV16722,0,0,14,3,6,8,0,31
ASV17918,25,0,0,0,0,0,6,31
ASV18234,0,1,0,2,3,4,21,31
ASV19638,0,0,6,3,19,3,0,31
ASV20042,0,0,0,0,31,0,0,31
ASV20049,0,0,0,0,0,31,0,31
ASV20727,1,0,4,9,7,5,5,31
ASV20777,0,0,0,24,0,2,5,31
ASV21589,15,0,0,16,0,0,0,31
ASV21843,0,0,6,0,3,22,0,31
ASV22098,0,31,0,0,0,0,0,31
ASV23585,6,2,9,1,3,4,6,31
ASV24405,6,6,2,1,0,0,16,31
ASV33,0,0,5,1,4,0,20,30
ASV84,0,5,14,0,0,11,0,30
ASV202,0,0,0,4,6,0,20,30
ASV292,23,0,0,0,7,0,0,30
ASV1096,0,0,0,0,26,4,0,30
ASV1317,9,7,0,0,0,0,14,30
ASV1892,0,5,18,4,1,0,2,30
ASV2126,0,30,0,0,0,0,0,30
ASV2383,0,0,0,5,11,0,14,30
ASV2689,0,0,8,1,6,2,13,30
ASV2834,0,0,14,5,6,3,2,30
ASV3247,0,0,9,15,6,0,0,30
ASV3837,0,0,11,0,0,19,0,30
ASV4453,6,0,0,3,3,0,18,30
ASV4468,6,0,0,0,0,0,24,30
ASV4502,0,2,18,9,0,1,0,30
ASV4943,0,0,20,2,0,6,2,30
ASV5124,0,4,0,6,13,3,4,30
ASV5222,0,12,13,0,0,0,5,30
ASV5405,0,0,0,6,0,13,11,30
ASV5454,0,0,6,0,0,11,13,30
ASV5797,0,0,3,12,15,0,0,30
ASV6394,0,4,5,8,5,7,1,30
ASV6874,0,0,0,0,15,0,15,30
ASV7298,0,3,4,3,1,16,3,30
ASV7874,0,0,7,0,0,23,0,30
ASV8117,0,0,0,0,17,0,13,30
ASV8227,0,2,5,9,0,8,6,30
ASV9086,0,0,0,3,9,4,14,30
ASV9516,0,2,8,1,1,12,6,30
ASV9539,0,0,0,23,0,0,7,30
ASV9616,10,7,4,1,0,6,2,30
ASV9685,0,23,0,0,0,6,1,30
ASV10092,0,7,0,5,0,18,0,30
ASV10122,2,6,4,3,4,0,11,30
ASV10763,0,0,8,9,3,9,1,30
ASV10983,0,0,2,1,25,0,2,30
ASV11240,8,0,0,7,2,0,13,30
ASV11353,0,0,8,6,10,0,6,30
ASV11944,3,1,6,0,2,13,5,30
ASV12000,0,11,0,3,0,0,16,30
ASV12420,10,0,0,0,0,20,0,30
ASV12836,4,0,9,7,10,0,0,30
ASV12858,0,0,0,0,0,30,0,30
ASV12937,0,0,11,0,0,0,19,30
ASV13375,0,0,7,3,0,6,14,30
ASV13611,11,0,0,1,0,11,7,30
ASV14249,4,3,3,0,6,0,14,30
ASV14334,0,0,15,4,11,0,0,30
ASV14514,0,0,9,12,6,0,3,30
ASV14620,0,0,0,29,0,0,1,30
ASV16155,0,0,13,5,0,12,0,30
ASV16361,0,12,2,0,0,9,7,30
ASV16560,0,0,0,8,4,11,7,30
ASV18030,0,6,23,1,0,0,0,30
ASV18640,0,14,2,0,8,0,6,30
ASV18849,0,0,0,0,18,0,12,30
ASV18937,3,0,8,9,0,10,0,30
ASV19265,6,0,5,7,0,8,4,30
ASV19326,0,10,3,5,12,0,0,30
ASV20629,0,0,0,0,7,0,23,30
ASV21041,0,4,0,2,0,0,24,30
ASV21291,0,0,0,0,10,1,19,30
ASV23072,0,0,1,2,4,12,11,30
ASV23236,0,0,5,0,8,0,17,30
ASV25142,0,0,1,7,10,0,12,30
ASV26888,0,0,4,0,0,17,9,30
ASV69,0,3,1,5,9,3,8,29
ASV408,10,10,2,1,0,3,3,29
ASV727,0,3,5,4,0,5,12,29
ASV854,0,7,5,0,10,0,7,29
ASV1003,4,0,6,6,3,10,0,29
ASV2364,0,0,0,18,0,11,0,29
ASV2544,4,0,6,0,0,19,0,29
ASV2551,0,0,0,18,0,0,11,29
ASV2833,4,13,0,3,5,2,2,29
ASV3066,0,12,0,0,8,4,5,29
ASV3171,0,0,8,3,7,0,11,29
ASV3257,0,7,7,4,10,1,0,29
ASV4285,2,0,12,3,0,3,9,29
ASV4688,0,1,8,12,4,0,4,29
ASV5131,0,0,24,0,0,5,0,29
ASV5258,7,7,4,0,10,1,0,29
ASV5390,0,0,0,0,29,0,0,29
ASV5671,1,2,10,0,3,11,2,29
ASV5998,0,0,0,0,29,0,0,29
ASV6055,0,0,7,6,4,0,12,29
ASV6124,0,4,6,5,7,0,7,29
ASV6260,0,4,1,11,2,8,3,29
ASV6341,0,0,12,7,3,3,4,29
ASV6632,0,2,25,2,0,0,0,29
ASV7262,0,0,1,6,15,4,3,29
ASV7338,0,13,16,0,0,0,0,29
ASV7636,0,0,17,9,1,2,0,29
ASV7893,9,1,0,0,19,0,0,29
ASV7904,0,1,9,15,0,0,4,29
ASV8006,0,0,22,0,0,6,1,29
ASV8172,0,0,9,0,6,14,0,29
ASV8508,0,8,7,2,7,0,5,29
ASV8627,0,0,0,23,0,4,2,29
ASV8701,0,5,8,0,0,16,0,29
ASV8722,1,8,0,7,8,0,5,29
ASV9006,3,0,4,10,7,0,5,29
ASV9144,0,11,0,1,1,8,8,29
ASV9296,0,13,0,8,0,0,8,29
ASV9680,0,5,19,0,0,0,5,29
ASV9740,0,19,0,0,3,0,7,29
ASV9760,0,9,0,0,0,0,20,29
ASV9841,0,0,0,4,25,0,0,29
ASV10330,0,0,24,2,0,3,0,29
ASV10693,0,0,0,18,4,0,7,29
ASV12216,0,1,0,7,1,3,17,29
ASV13473,0,0,3,0,26,0,0,29
ASV13897,0,5,20,0,2,0,2,29
ASV14434,0,0,0,5,5,12,7,29
ASV14721,0,13,0,16,0,0,0,29
ASV14982,2,0,0,5,2,0,20,29
ASV15126,0,6,4,13,0,6,0,29
ASV15460,0,8,8,0,5,4,4,29
ASV15847,0,0,0,5,0,0,24,29
ASV15944,0,2,8,0,0,19,0,29
ASV15946,0,0,0,11,9,2,7,29
ASV16930,0,0,29,0,0,0,0,29
ASV17223,0,0,0,0,0,25,4,29
ASV17926,1,9,0,0,0,0,19,29
ASV18350,4,0,2,7,0,16,0,29
ASV18401,0,0,0,0,0,24,5,29
ASV18402,3,17,9,0,0,0,0,29
ASV18999,6,0,0,0,13,0,10,29
ASV19388,14,0,5,0,0,10,0,29
ASV19886,0,0,10,0,8,4,7,29
ASV19966,0,2,7,0,0,3,17,29
ASV20124,0,0,0,0,0,0,29,29
ASV20445,0,25,0,4,0,0,0,29
ASV21029,0,0,29,0,0,0,0,29
ASV21411,0,0,0,0,29,0,0,29
ASV22346,0,13,5,11,0,0,0,29
ASV22495,0,0,0,0,0,0,29,29
ASV22801,0,0,0,8,11,0,10,29
ASV22,0,0,10,7,9,0,2,28
ASV100,0,1,0,17,6,0,4,28
ASV109,0,3,6,6,0,12,1,28
ASV239,7,8,5,0,0,0,8,28
ASV311,0,0,10,15,3,0,0,28
ASV395,0,0,6,0,0,16,6,28
ASV413,0,0,9,9,6,4,0,28
ASV1438,0,0,7,8,1,0,12,28
ASV2218,0,26,0,2,0,0,0,28
ASV2496,0,6,0,4,8,2,8,28
ASV2567,2,0,0,0,18,0,8,28
ASV2590,0,0,13,5,10,0,0,28
ASV2999,0,10,4,7,0,0,7,28
ASV3141,2,0,3,17,5,0,1,28
ASV3729,0,0,28,0,0,0,0,28
ASV4127,0,3,7,4,0,0,14,28
ASV4194,0,10,15,0,3,0,0,28
ASV4314,0,0,0,0,0,28,0,28
ASV4681,0,0,0,27,1,0,0,28
ASV4732,3,0,10,0,6,2,7,28
ASV4840,14,0,2,8,0,2,2,28
ASV5005,0,0,3,1,12,12,0,28
ASV5088,1,0,1,4,15,0,7,28
ASV5260,0,0,0,2,0,18,8,28
ASV5637,0,0,0,6,2,20,0,28
ASV5650,0,2,5,7,0,0,14,28
ASV5935,0,0,2,0,0,19,7,28
ASV6219,2,0,9,0,2,3,12,28
ASV6227,0,0,19,0,0,0,9,28
ASV6433,0,0,0,7,3,12,6,28
ASV6541,12,0,0,0,0,0,16,28
ASV6577,0,14,0,0,0,0,14,28
ASV6615,0,0,1,0,6,21,0,28
ASV6625,0,8,7,13,0,0,0,28
ASV6878,0,0,7,12,0,9,0,28
ASV6931,2,1,9,0,1,5,10,28
ASV7476,0,2,0,0,6,0,20,28
ASV7652,0,2,0,12,4,8,2,28
ASV7776,0,0,7,6,2,11,2,28
ASV8012,0,0,7,4,2,10,5,28
ASV8444,0,14,13,0,1,0,0,28
ASV8547,3,1,0,5,2,4,13,28
ASV8673,0,0,6,18,1,1,2,28
ASV8937,8,8,0,0,4,5,3,28
ASV8973,0,1,0,6,14,3,4,28
ASV9886,0,0,3,10,7,6,2,28
ASV10216,7,0,4,5,3,0,9,28
ASV10245,0,9,12,0,7,0,0,28
ASV10303,0,0,17,3,1,0,7,28
ASV10573,3,0,6,5,0,0,14,28
ASV10636,0,8,0,11,0,5,4,28
ASV10713,0,4,0,2,10,0,12,28
ASV10735,3,0,9,13,0,3,0,28
ASV11465,28,0,0,0,0,0,0,28
ASV12395,6,0,6,6,0,5,5,28
ASV12659,0,11,0,14,3,0,0,28
ASV12723,0,4,10,2,0,6,6,28
ASV13227,6,3,0,8,3,0,8,28
ASV13323,0,21,0,2,5,0,0,28
ASV13351,0,0,0,1,0,0,27,28
ASV13354,0,0,2,1,0,25,0,28
ASV13632,0,12,0,4,0,12,0,28
ASV13733,10,0,0,2,0,13,3,28
ASV13852,4,13,6,0,4,0,1,28
ASV13879,0,5,14,0,5,1,3,28
ASV16491,0,0,0,0,0,0,28,28
ASV16964,0,0,7,5,10,0,6,28
ASV18070,0,0,3,10,0,0,15,28
ASV18227,0,0,0,0,0,28,0,28
ASV19300,0,0,0,25,0,0,3,28
ASV19809,0,0,4,0,0,0,24,28
ASV19894,0,3,1,12,12,0,0,28
ASV20530,0,0,28,0,0,0,0,28
ASV21006,0,0,4,1,0,20,3,28
ASV21941,0,0,3,0,0,0,25,28
ASV22540,0,0,0,0,0,0,28,28
ASV23465,0,0,0,0,24,0,4,28
ASV24058,0,1,14,7,0,2,4,28
ASV24327,0,3,2,6,10,0,7,28
ASV25339,0,11,4,3,3,7,0,28
ASV26895,0,5,8,6,2,7,0,28
ASV616,4,0,0,3,3,6,11,27
ASV748,0,5,3,1,2,6,10,27
ASV1206,0,6,0,0,0,21,0,27
ASV1207,0,5,11,5,0,0,6,27
ASV1513,0,0,0,0,26,0,1,27
ASV1605,0,1,16,0,0,0,10,27
ASV1721,0,3,10,3,3,0,8,27
ASV1793,0,0,0,4,4,0,19,27
ASV2208,0,0,4,5,13,0,5,27
ASV2414,0,6,0,6,7,8,0,27
ASV2458,0,1,7,1,5,10,3,27
ASV2504,0,7,0,6,4,2,8,27
ASV2817,5,3,0,3,7,0,9,27
ASV3076,0,0,13,10,1,3,0,27
ASV3186,0,3,0,0,7,9,8,27
ASV3375,3,0,0,18,6,0,0,27
ASV3615,0,0,26,0,0,0,1,27
ASV4124,1,5,0,12,1,5,3,27
ASV4451,0,4,0,6,9,0,8,27
ASV4667,0,0,0,0,27,0,0,27
ASV4734,0,0,0,0,0,19,8,27
ASV4908,0,0,13,8,0,3,3,27
ASV5199,0,0,4,0,0,23,0,27
ASV5357,0,1,4,0,2,14,6,27
ASV5436,0,9,0,0,9,0,9,27
ASV5942,3,5,0,6,0,13,0,27
ASV6455,0,0,0,0,1,0,26,27
ASV6565,0,0,2,0,3,12,10,27
ASV6610,0,9,10,5,1,0,2,27
ASV6658,0,3,1,3,5,12,3,27
ASV6895,4,0,8,0,5,2,8,27
ASV6971,0,0,0,0,26,0,1,27
ASV6984,0,0,0,4,0,23,0,27
ASV7067,0,0,4,5,4,5,9,27
ASV7528,0,0,9,8,1,0,9,27
ASV7635,0,7,9,2,3,0,6,27
ASV8044,0,0,0,4,5,0,18,27
ASV8123,1,8,4,1,0,0,13,27
ASV8254,8,3,2,5,2,1,6,27
ASV8612,0,0,0,1,0,2,24,27
ASV8717,2,1,2,21,0,0,1,27
ASV8759,0,1,7,3,7,7,2,27
ASV9183,2,9,0,0,10,4,2,27
ASV9220,0,0,0,0,0,0,27,27
ASV9589,6,0,0,13,4,1,3,27
ASV9748,0,0,5,4,7,4,7,27
ASV9771,0,0,15,12,0,0,0,27
ASV9806,0,0,0,12,15,0,0,27
ASV10235,0,0,27,0,0,0,0,27
ASV10523,0,13,2,0,5,0,7,27
ASV10648,0,4,9,0,12,2,0,27
ASV10721,0,0,0,0,14,0,13,27
ASV10819,0,12,0,0,9,6,0,27
ASV11128,7,0,0,11,0,8,1,27
ASV11736,0,0,6,7,0,0,14,27
ASV12878,0,0,18,0,0,0,9,27
ASV13751,0,0,4,7,1,0,15,27
ASV13978,13,0,0,0,3,3,8,27
ASV14440,0,11,16,0,0,0,0,27
ASV15173,0,0,0,26,0,1,0,27
ASV15478,0,2,0,10,15,0,0,27
ASV15546,0,5,1,7,0,4,10,27
ASV15920,8,5,7,0,5,0,2,27
ASV16708,17,7,0,0,0,3,0,27
ASV16857,0,0,0,27,0,0,0,27
ASV17352,2,5,0,2,1,14,3,27
ASV17467,0,1,18,1,1,0,6,27
ASV17624,2,6,7,0,1,11,0,27
ASV17659,0,22,0,0,0,5,0,27
ASV18369,0,2,0,0,0,25,0,27
ASV18631,1,0,23,0,0,0,3,27
ASV18902,0,5,3,5,3,2,9,27
ASV18990,2,0,4,0,1,15,5,27
ASV19658,0,0,0,0,0,27,0,27
ASV20057,1,5,10,0,0,0,11,27
ASV20591,0,2,0,3,0,5,17,27
ASV20756,0,0,0,0,4,1,22,27
ASV20844,0,0,0,3,1,4,19,27
ASV21377,0,0,6,4,3,7,7,27
ASV21427,0,0,0,15,7,0,5,27
ASV21810,0,6,0,3,17,0,1,27
ASV21845,0,20,0,7,0,0,0,27
ASV22834,0,0,27,0,0,0,0,27
ASV23122,11,0,6,0,0,10,0,27
ASV23340,0,8,0,0,18,1,0,27
ASV23850,0,0,0,0,11,0,16,27
ASV23967,0,0,0,0,0,0,27,27
ASV24209,0,27,0,0,0,0,0,27
ASV24235,0,0,0,0,0,0,27,27
ASV24389,0,2,8,0,17,0,0,27
ASV24590,0,0,0,0,0,0,27,27
ASV26659,0,0,18,0,0,0,9,27
ASV27012,0,0,17,3,3,0,4,27
ASV27053,0,0,7,0,4,9,7,27
ASV27094,0,6,0,0,0,0,21,27
ASV212,0,0,7,6,4,1,8,26
ASV215,0,0,5,0,0,10,11,26
ASV366,1,8,3,2,3,3,6,26
ASV1031,0,1,14,8,3,0,0,26
ASV1287,7,1,16,0,2,0,0,26
ASV1689,0,6,0,13,3,0,4,26
ASV1953,0,0,0,1,4,0,21,26
ASV2203,5,17,3,1,0,0,0,26
ASV2294,0,15,0,0,0,11,0,26
ASV2300,3,2,4,2,1,14,0,26
ASV3587,0,0,0,0,0,1,25,26
ASV3733,0,16,0,0,0,3,7,26
ASV4348,0,4,2,0,0,0,20,26
ASV4838,0,2,0,0,13,2,9,26
ASV4906,2,0,0,0,2,22,0,26
ASV4950,0,0,4,7,0,0,15,26
ASV5008,0,12,3,3,0,5,3,26
ASV5116,0,0,5,1,0,0,20,26
ASV5211,7,2,2,3,5,3,4,26
ASV5270,5,0,4,12,0,5,0,26
ASV5273,0,0,21,0,5,0,0,26
ASV5294,0,7,0,0,0,0,19,26
ASV5321,0,3,3,0,10,0,10,26
ASV5570,0,0,0,0,0,26,0,26
ASV5593,4,0,3,12,0,1,6,26
ASV5690,0,0,0,0,0,7,19,26
ASV5936,0,12,7,0,0,4,3,26
ASV5971,0,0,0,0,14,1,11,26
ASV5992,0,0,0,26,0,0,0,26
ASV6361,0,0,13,2,0,11,0,26
ASV6437,0,3,3,0,3,11,6,26
ASV6514,0,6,6,5,0,5,4,26
ASV7210,0,0,0,1,25,0,0,26
ASV7758,0,9,8,2,1,0,6,26
ASV8379,0,10,2,5,0,2,7,26
ASV9120,0,0,10,3,0,13,0,26
ASV9217,0,0,0,3,1,20,2,26
ASV9313,0,7,4,2,0,9,4,26
ASV9317,0,0,0,0,0,0,26,26
ASV9476,0,0,0,15,11,0,0,26
ASV9572,0,0,9,10,2,0,5,26
ASV9585,0,0,6,0,12,8,0,26
ASV9731,0,3,0,2,14,1,6,26
ASV10475,4,3,12,0,4,3,0,26
ASV10615,0,0,2,0,0,0,24,26
ASV10716,0,0,0,25,0,0,1,26
ASV11152,0,0,1,6,5,10,4,26
ASV11724,0,0,4,3,5,0,14,26
ASV12096,0,0,13,0,5,4,4,26
ASV12210,0,0,20,0,0,6,0,26
ASV12321,0,0,0,0,5,0,21,26
ASV12809,0,3,7,0,3,13,0,26
ASV13162,0,6,4,0,11,4,1,26
ASV14584,0,1,0,0,0,0,25,26
ASV15330,0,0,22,0,0,2,2,26
ASV15954,0,11,10,1,1,0,3,26
ASV15986,0,0,0,5,9,0,12,26
ASV16742,0,6,16,2,0,1,1,26
ASV16858,0,0,26,0,0,0,0,26
ASV17138,0,5,8,0,9,0,4,26
ASV17190,0,2,0,0,21,0,3,26
ASV17606,0,3,0,5,13,5,0,26
ASV17697,0,0,2,5,10,0,9,26
ASV18130,0,0,4,3,4,15,0,26
ASV18274,25,0,0,0,0,1,0,26
ASV18357,0,0,1,3,3,19,0,26
ASV19153,0,13,7,4,0,0,2,26
ASV20213,0,0,0,0,11,0,15,26
ASV21520,0,0,17,1,8,0,0,26
ASV22328,0,0,6,0,0,0,20,26
ASV22569,17,0,0,9,0,0,0,26
ASV22659,3,0,7,11,1,4,0,26
ASV24019,0,2,0,0,24,0,0,26
ASV24427,0,0,9,17,0,0,0,26
ASV26373,0,0,19,0,3,0,4,26
ASV613,2,5,3,5,5,0,5,25
ASV680,0,3,5,17,0,0,0,25
ASV768,0,10,4,3,8,0,0,25
ASV1129,0,0,7,4,4,10,0,25
ASV1173,0,0,3,20,0,2,0,25
ASV1204,0,0,20,1,4,0,0,25
ASV1667,0,2,6,0,1,0,16,25
ASV1853,0,0,10,9,3,1,2,25
ASV1977,0,1,6,1,12,0,5,25
ASV2045,0,9,8,2,0,6,0,25
ASV2792,0,0,3,0,1,5,16,25
ASV3279,0,0,2,0,19,4,0,25
ASV3319,0,0,9,0,0,0,16,25
ASV3525,0,0,7,10,8,0,0,25
ASV3694,0,0,7,16,0,2,0,25
ASV3712,0,3,8,4,1,5,4,25
ASV3899,0,0,16,4,0,5,0,25
ASV3962,0,0,0,6,6,0,13,25
ASV3991,0,7,4,13,0,1,0,25
ASV4476,0,19,0,0,6,0,0,25
ASV4714,0,11,0,0,0,14,0,25
ASV4724,0,0,0,0,0,0,25,25
ASV4790,0,0,11,3,0,10,1,25
ASV4797,0,4,0,5,1,0,15,25
ASV4809,0,8,9,0,2,6,0,25
ASV5035,11,2,0,10,2,0,0,25
ASV5443,0,0,0,0,18,0,7,25
ASV5748,0,0,10,0,3,2,10,25
ASV5963,0,0,2,0,14,9,0,25
ASV6251,0,0,10,0,15,0,0,25
ASV6912,0,25,0,0,0,0,0,25
ASV6987,0,4,1,0,6,0,14,25
ASV7020,0,0,0,25,0,0,0,25
ASV7093,0,0,25,0,0,0,0,25
ASV7125,15,0,0,0,0,5,5,25
ASV7363,0,0,5,7,9,0,4,25
ASV7533,0,2,2,3,12,1,5,25
ASV7601,0,6,1,1,7,3,7,25
ASV7795,0,9,0,0,0,16,0,25
ASV7839,0,9,5,1,2,6,2,25
ASV8354,6,3,11,0,2,0,3,25
ASV8469,0,0,0,0,16,0,9,25
ASV9134,0,3,13,0,3,0,6,25
ASV9175,4,0,7,1,9,2,2,25
ASV9245,0,0,0,1,24,0,0,25
ASV9253,0,0,14,11,0,0,0,25
ASV9715,0,0,0,0,4,0,21,25
ASV9754,0,4,9,0,0,12,0,25
ASV9924,5,0,1,7,4,8,0,25
ASV9994,0,7,0,0,5,2,11,25
ASV10719,0,0,12,0,8,5,0,25
ASV10773,25,0,0,0,0,0,0,25
ASV11053,0,0,0,22,0,1,2,25
ASV11150,0,8,0,4,7,0,6,25
ASV11231,7,0,0,6,1,11,0,25
ASV11297,0,0,10,0,6,0,9,25
ASV11517,0,4,9,0,0,8,4,25
ASV11618,0,0,0,0,12,13,0,25
ASV11662,0,0,18,0,6,1,0,25
ASV11918,0,0,0,0,8,0,17,25
ASV12396,0,0,2,0,8,6,9,25
ASV12564,0,0,12,13,0,0,0,25
ASV12672,4,2,3,0,2,7,7,25
ASV13496,0,0,0,6,0,19,0,25
ASV13723,0,0,4,21,0,0,0,25
ASV13732,3,0,5,0,3,14,0,25
ASV14093,0,2,11,0,0,10,2,25
ASV14353,0,0,7,0,0,13,5,25
ASV14499,0,2,0,0,10,0,13,25
ASV14664,0,0,14,11,0,0,0,25
ASV14917,0,0,2,17,3,1,2,25
ASV15107,0,0,0,5,0,16,4,25
ASV15213,4,17,0,0,0,0,4,25
ASV16297,0,6,0,11,3,0,5,25
ASV16459,0,0,8,3,5,5,4,25
ASV16676,25,0,0,0,0,0,0,25
ASV16835,15,0,1,0,6,3,0,25
ASV17498,0,14,1,10,0,0,0,25
ASV17538,0,0,0,25,0,0,0,25
ASV17807,0,2,0,0,0,0,23,25
ASV17925,1,0,0,0,0,7,17,25
ASV18084,0,0,7,12,0,1,5,25
ASV18794,0,7,13,1,2,1,1,25
ASV18847,0,0,0,0,0,0,25,25
ASV21422,0,0,11,14,0,0,0,25
ASV22364,0,0,22,0,0,0,3,25
ASV22429,0,0,6,10,2,2,5,25
ASV22680,0,1,0,0,6,1,17,25
ASV23079,14,0,6,1,0,4,0,25
ASV23279,0,0,25,0,0,0,0,25
ASV23767,7,0,0,4,14,0,0,25
ASV24459,0,0,5,14,6,0,0,25
ASV25263,0,0,0,0,22,0,3,25
ASV25346,0,2,9,7,0,5,2,25
ASV25700,0,20,0,5,0,0,0,25
ASV27055,0,0,0,17,0,0,8,25
ASV470,0,0,10,14,0,0,0,24
ASV599,0,5,2,4,0,0,13,24
ASV1005,1,1,2,5,11,0,4,24
ASV1032,3,0,7,5,0,3,6,24
ASV1071,0,0,5,4,10,0,5,24
ASV1229,0,0,7,3,8,1,5,24
ASV1396,0,0,0,2,21,0,1,24
ASV1703,0,1,0,6,5,0,12,24
ASV2141,0,0,0,17,2,0,5,24
ASV2385,0,8,6,6,0,2,2,24
ASV2399,1,19,0,0,1,3,0,24
ASV2510,0,3,0,4,0,0,17,24
ASV3493,0,3,2,0,19,0,0,24
ASV3609,7,5,3,0,2,3,4,24
ASV3988,0,15,0,4,0,0,5,24
ASV4010,0,0,6,0,16,2,0,24
ASV4118,0,0,6,7,0,2,9,24
ASV4126,24,0,0,0,0,0,0,24
ASV4266,0,0,13,1,3,7,0,24
ASV4637,0,0,14,0,0,0,10,24
ASV4841,0,0,0,10,14,0,0,24
ASV4886,0,0,4,1,6,9,4,24
ASV4995,0,4,3,0,10,7,0,24
ASV5087,0,0,16,8,0,0,0,24
ASV5117,10,0,7,0,6,0,1,24
ASV5276,0,2,2,0,17,0,3,24
ASV5501,0,0,9,3,12,0,0,24
ASV5583,0,0,0,24,0,0,0,24
ASV6252,0,0,7,1,0,11,5,24
ASV6374,0,4,5,1,12,2,0,24
ASV6856,0,11,9,0,0,3,1,24
ASV7272,0,0,4,10,0,1,9,24
ASV7546,2,0,6,0,0,12,4,24
ASV8496,0,0,5,7,7,1,4,24
ASV8554,0,0,7,7,0,10,0,24
ASV8975,0,0,6,5,3,6,4,24
ASV9047,0,1,7,0,0,15,1,24
ASV9146,0,0,17,0,0,7,0,24
ASV9374,24,0,0,0,0,0,0,24
ASV9541,0,0,3,0,1,10,10,24
ASV9783,0,0,4,2,13,5,0,24
ASV9800,0,0,21,3,0,0,0,24
ASV9918,0,0,0,0,4,0,20,24
ASV10117,5,0,3,2,2,5,7,24
ASV10259,0,0,0,0,0,0,24,24
ASV10282,0,5,0,0,0,14,5,24
ASV10294,3,2,10,4,4,0,1,24
ASV10532,0,0,0,0,24,0,0,24
ASV10588,0,3,6,5,8,0,2,24
ASV11463,0,0,8,2,6,4,4,24
ASV11472,0,0,0,5,2,0,17,24
ASV11514,1,0,9,0,6,0,8,24
ASV12003,2,2,0,6,4,2,8,24
ASV12069,0,0,15,0,0,9,0,24
ASV12392,16,0,0,0,3,1,4,24
ASV12540,0,0,11,0,12,1,0,24
ASV12857,0,2,4,4,0,0,14,24
ASV13038,4,2,10,0,0,8,0,24
ASV13477,0,0,0,4,0,20,0,24
ASV13547,7,4,3,2,0,5,3,24
ASV13971,14,0,0,0,10,0,0,24
ASV14170,0,24,0,0,0,0,0,24
ASV14462,1,12,0,11,0,0,0,24
ASV14616,0,10,10,0,0,3,1,24
ASV15066,0,0,0,4,14,1,5,24
ASV15365,0,0,0,0,0,0,24,24
ASV15463,0,0,0,0,24,0,0,24
ASV15485,0,1,0,7,14,0,2,24
ASV15886,0,2,2,8,9,0,3,24
ASV16347,0,0,0,4,3,11,6,24
ASV16642,0,0,10,0,0,2,12,24
ASV16675,0,6,0,0,9,6,3,24
ASV16783,0,0,8,8,2,0,6,24
ASV17664,0,0,8,5,1,8,2,24
ASV18458,0,0,0,0,18,0,6,24
ASV18499,0,3,0,12,4,3,2,24
ASV18982,0,0,0,0,21,0,3,24
ASV19617,0,15,9,0,0,0,0,24
ASV20105,0,0,0,24,0,0,0,24
ASV20440,0,0,10,0,0,14,0,24
ASV20672,0,0,5,1,18,0,0,24
ASV20876,0,4,5,5,9,1,0,24
ASV21033,0,0,0,0,8,0,16,24
ASV21211,0,0,5,9,9,0,1,24
ASV22292,0,0,0,2,10,0,12,24
ASV22763,0,0,1,0,0,15,8,24
ASV24617,0,0,0,3,10,0,11,24
ASV367,2,0,3,10,0,0,8,23
ASV390,0,2,0,6,15,0,0,23
ASV600,0,5,2,0,4,3,9,23
ASV1491,0,1,2,10,3,7,0,23
ASV1843,2,8,1,6,0,3,3,23
ASV2234,2,0,3,7,11,0,0,23
ASV2938,4,10,0,1,0,0,8,23
ASV3213,0,0,0,0,0,0,23,23
ASV3352,0,0,2,0,6,8,7,23
ASV3559,0,0,0,0,7,7,9,23
ASV3630,18,0,2,0,0,3,0,23
ASV3650,1,0,8,2,3,8,1,23
ASV3902,0,0,8,5,5,0,5,23
ASV4555,0,0,4,4,10,0,5,23
ASV4965,1,0,0,0,2,18,2,23
ASV5371,0,0,0,0,14,0,9,23
ASV6068,1,0,2,8,10,0,2,23
ASV6206,0,0,0,0,0,23,0,23
ASV6344,0,0,4,17,2,0,0,23
ASV6448,0,0,0,1,18,0,4,23
ASV6648,0,11,5,1,6,0,0,23
ASV6710,0,0,5,6,3,3,6,23
ASV6804,6,0,0,0,17,0,0,23
ASV6938,0,0,2,16,5,0,0,23
ASV7309,8,0,7,3,1,4,0,23
ASV7325,4,5,0,2,3,6,3,23
ASV7789,3,0,10,0,0,6,4,23
ASV8931,2,0,0,6,8,0,7,23
ASV9440,0,0,0,13,3,5,2,23
ASV9460,0,0,9,0,2,6,6,23
ASV9537,0,8,0,4,9,0,2,23
ASV9538,2,0,0,2,1,9,9,23
ASV9763,0,5,5,1,2,7,3,23
ASV9768,3,0,2,3,0,8,7,23
ASV10273,0,2,5,6,0,0,10,23
ASV10280,0,0,9,6,8,0,0,23
ASV10292,0,5,0,9,5,3,1,23
ASV10575,1,3,10,3,4,1,1,23
ASV11030,0,3,4,4,0,5,7,23
ASV12099,0,8,0,3,9,3,0,23
ASV12254,0,0,0,5,3,11,4,23
ASV12840,0,4,12,7,0,0,0,23
ASV13059,0,0,12,2,0,6,3,23
ASV13359,0,0,1,17,4,1,0,23
ASV14256,0,0,5,0,2,11,5,23
ASV14611,2,0,0,13,5,1,2,23
ASV14640,0,2,14,4,0,0,3,23
ASV15230,0,0,7,0,13,3,0,23
ASV15255,0,0,0,0,3,0,20,23
ASV15894,0,6,0,0,0,0,17,23
ASV16894,0,2,5,11,0,0,5,23
ASV16948,0,2,2,2,14,2,1,23
ASV17178,0,1,17,0,0,5,0,23
ASV17782,6,8,1,0,0,0,8,23
ASV19882,0,0,0,0,5,7,11,23
ASV20456,0,7,3,4,5,4,0,23
ASV20488,0,0,8,0,2,13,0,23
ASV21395,0,0,0,0,23,0,0,23
ASV21576,0,0,6,5,3,4,5,23
ASV24495,0,3,3,0,0,12,5,23
ASV24747,0,3,0,5,7,0,8,23
ASV24780,0,0,3,0,20,0,0,23
ASV26135,0,0,0,2,11,10,0,23
ASV222,0,1,1,6,3,11,0,22
ASV348,0,0,4,5,3,7,3,22
ASV369,0,0,0,0,2,15,5,22
ASV834,0,0,0,0,22,0,0,22
ASV936,6,7,0,3,0,0,6,22
ASV975,0,0,5,0,0,13,4,22
ASV1036,0,0,6,0,9,7,0,22
ASV1617,0,0,14,2,0,6,0,22
ASV2418,0,0,12,10,0,0,0,22
ASV2430,0,4,0,3,4,2,9,22
ASV2637,0,2,0,17,0,0,3,22
ASV2700,12,0,2,3,0,5,0,22
ASV2916,0,0,7,7,0,8,0,22
ASV2936,0,2,4,4,2,5,5,22
ASV3056,0,0,0,22,0,0,0,22
ASV3519,0,0,7,4,0,9,2,22
ASV3996,0,0,9,9,1,3,0,22
ASV4339,0,6,6,0,9,0,1,22
ASV4512,0,8,0,0,2,0,12,22
ASV4519,0,6,2,0,0,10,4,22
ASV5024,0,0,9,5,8,0,0,22
ASV5108,0,0,0,1,14,7,0,22
ASV5301,0,4,10,4,4,0,0,22
ASV5989,0,0,0,22,0,0,0,22
ASV6113,0,0,10,10,0,0,2,22
ASV6182,0,0,0,2,13,0,7,22
ASV6186,0,0,0,1,0,0,21,22
ASV6319,0,22,0,0,0,0,0,22
ASV6675,0,0,13,2,4,0,3,22
ASV6720,0,0,0,14,8,0,0,22
ASV6860,3,0,0,0,0,19,0,22
ASV7131,3,0,8,2,3,6,0,22
ASV7152,0,4,0,6,7,3,2,22
ASV7407,0,3,0,2,5,0,12,22
ASV7591,0,3,5,7,4,1,2,22
ASV7666,0,0,2,6,1,5,8,22
ASV7852,1,0,9,1,3,0,8,22
ASV7877,0,0,4,0,0,0,18,22
ASV7927,3,8,0,1,7,3,0,22
ASV7957,0,4,5,0,4,3,6,22
ASV8115,0,0,3,0,0,7,12,22
ASV8196,0,4,8,4,6,0,0,22
ASV8506,1,6,0,4,0,10,1,22
ASV8887,0,1,0,1,0,0,20,22
ASV9040,1,1,8,0,0,1,11,22
ASV9107,0,0,15,0,5,0,2,22
ASV9122,0,0,0,0,7,6,9,22
ASV9277,0,0,0,11,9,0,2,22
ASV9284,0,0,0,3,10,5,4,22
ASV9302,0,0,9,0,0,0,13,22
ASV10195,0,0,3,17,0,0,2,22
ASV10696,0,9,0,0,13,0,0,22
ASV10812,0,0,4,11,5,0,2,22
ASV11196,0,7,0,0,15,0,0,22
ASV11581,0,0,2,1,0,0,19,22
ASV11766,0,0,6,2,1,0,13,22
ASV12106,0,14,8,0,0,0,0,22
ASV12705,0,8,3,8,0,0,3,22
ASV13318,2,1,3,5,3,2,6,22
ASV13376,0,0,0,0,0,22,0,22
ASV13410,0,0,13,0,0,2,7,22
ASV13589,0,0,4,0,0,8,10,22
ASV13814,2,3,2,4,8,0,3,22
ASV14178,0,0,0,1,21,0,0,22
ASV14332,0,2,1,4,0,9,6,22
ASV14373,0,0,3,0,13,2,4,22
ASV14534,0,4,0,1,11,0,6,22
ASV14787,0,0,1,6,8,0,7,22
ASV14918,0,0,8,13,1,0,0,22
ASV15085,0,0,0,1,12,0,9,22
ASV15653,0,0,9,13,0,0,0,22
ASV16739,0,0,0,0,0,0,22,22
ASV17642,0,8,0,5,6,0,3,22
ASV17679,0,0,8,5,9,0,0,22
ASV17869,0,17,0,3,0,2,0,22
ASV18459,0,13,0,0,1,0,8,22
ASV18739,4,0,6,0,12,0,0,22
ASV18746,0,0,6,0,4,0,12,22
ASV18822,0,2,4,0,6,4,6,22
ASV19459,6,0,0,3,6,0,7,22
ASV20005,0,0,2,0,0,16,4,22
ASV20092,0,3,9,10,0,0,0,22
ASV20749,0,2,0,0,3,0,17,22
ASV20809,0,0,0,0,0,22,0,22
ASV20874,0,0,0,11,1,0,10,22
ASV20922,0,0,0,0,22,0,0,22
ASV21004,0,0,4,6,12,0,0,22
ASV21310,0,0,0,22,0,0,0,22
ASV21552,0,0,0,18,4,0,0,22
ASV21587,0,8,0,0,7,0,7,22
ASV23504,0,0,0,0,11,0,11,22
ASV23743,4,0,6,11,0,0,1,22
ASV24136,2,4,9,2,0,5,0,22
ASV341,0,14,0,0,0,7,0,21
ASV498,0,0,7,0,0,4,10,21
ASV775,0,0,3,8,0,0,10,21
ASV810,0,9,5,2,5,0,0,21
ASV1106,0,1,0,0,4,0,16,21
ASV1429,6,2,0,2,0,0,11,21
ASV1458,0,0,0,7,7,7,0,21
ASV1496,0,0,0,0,0,7,14,21
ASV1652,3,3,4,2,2,2,5,21
ASV2065,7,3,10,1,0,0,0,21
ASV2085,0,0,0,19,0,0,2,21
ASV2306,0,0,1,0,0,15,5,21
ASV2518,0,0,0,19,0,0,2,21
ASV2998,5,0,4,0,1,9,2,21
ASV3019,0,1,2,13,0,5,0,21
ASV3240,0,1,14,1,4,0,1,21
ASV3426,0,0,0,0,0,0,21,21
ASV3623,0,0,15,0,0,3,3,21
ASV3651,0,3,0,1,17,0,0,21
ASV3661,1,6,8,6,0,0,0,21
ASV3691,0,0,0,12,5,0,4,21
ASV3911,0,0,0,4,1,14,2,21
ASV3980,0,0,0,0,5,0,16,21
ASV4485,0,0,0,8,0,0,13,21
ASV4662,0,0,3,11,2,2,3,21
ASV4680,0,0,0,0,0,21,0,21
ASV5085,0,5,3,3,6,0,4,21
ASV5201,0,3,0,15,3,0,0,21
ASV5386,0,0,0,0,0,0,21,21
ASV5536,7,0,0,3,7,1,3,21
ASV5586,0,7,0,0,4,6,4,21
ASV6235,0,0,6,0,0,7,8,21
ASV6470,0,21,0,0,0,0,0,21
ASV6603,6,0,0,5,0,6,4,21
ASV6990,0,0,0,0,8,13,0,21
ASV7064,7,3,0,2,5,0,4,21
ASV7367,6,3,0,2,0,7,3,21
ASV8118,0,0,0,0,21,0,0,21
ASV8290,0,0,0,0,0,0,21,21
ASV8407,0,0,0,0,0,0,21,21
ASV9069,1,0,1,7,12,0,0,21
ASV9240,0,0,0,6,2,0,13,21
ASV9627,0,0,0,3,16,0,2,21
ASV9688,4,4,2,0,4,0,7,21
ASV10096,2,3,0,5,1,5,5,21
ASV10227,1,0,20,0,0,0,0,21
ASV10355,0,0,0,0,20,0,1,21
ASV10561,0,0,0,0,0,2,19,21
ASV10736,7,0,0,10,0,0,4,21
ASV10931,0,5,6,0,1,0,9,21
ASV11379,3,7,8,3,0,0,0,21
ASV11398,0,0,6,0,0,6,9,21
ASV11412,0,4,0,0,13,4,0,21
ASV11752,0,0,0,21,0,0,0,21
ASV11821,0,0,1,14,6,0,0,21
ASV12257,4,1,8,0,1,7,0,21
ASV12896,3,7,8,1,2,0,0,21
ASV13072,0,0,7,5,0,0,9,21
ASV13155,0,9,9,0,0,0,3,21
ASV13461,0,0,4,0,11,6,0,21
ASV13504,0,8,4,4,5,0,0,21
ASV13792,0,0,5,0,6,8,2,21
ASV13958,0,0,10,0,4,7,0,21
ASV14205,0,0,16,2,0,1,2,21
ASV14535,0,15,0,0,0,0,6,21
ASV14603,0,1,10,2,7,1,0,21
ASV14780,0,3,4,0,8,6,0,21
ASV14839,11,0,4,0,0,0,6,21
ASV14850,0,0,0,0,0,0,21,21
ASV15302,0,0,6,4,9,0,2,21
ASV15808,3,0,1,4,0,5,8,21
ASV15935,0,0,10,0,9,2,0,21
ASV15996,0,0,12,9,0,0,0,21
ASV16859,1,0,1,2,9,0,8,21
ASV16902,0,0,17,0,0,4,0,21
ASV16999,0,8,0,7,5,0,1,21
ASV18140,0,0,15,1,2,0,3,21
ASV18455,0,0,3,0,0,0,18,21
ASV19613,0,0,0,0,21,0,0,21
ASV19634,0,15,6,0,0,0,0,21
ASV19669,0,0,0,1,1,17,2,21
ASV19875,6,0,0,3,0,4,8,21
ASV20322,0,0,0,0,0,0,21,21
ASV20549,0,0,0,21,0,0,0,21
ASV21028,6,0,0,0,0,15,0,21
ASV21244,0,0,0,0,2,11,8,21
ASV22226,4,3,0,9,0,0,5,21
ASV23576,0,0,0,2,0,17,2,21
ASV23702,0,0,7,7,4,0,3,21
ASV24372,0,0,5,0,0,14,2,21
ASV25015,0,0,0,0,10,0,11,21
ASV25186,21,0,0,0,0,0,0,21
ASV25476,0,0,0,21,0,0,0,21
ASV26860,0,0,4,3,11,0,3,21
ASV26920,7,6,5,0,3,0,0,21
ASV305,0,4,0,0,3,0,13,20
ASV360,0,0,0,0,3,0,17,20
ASV375,0,0,7,3,10,0,0,20
ASV440,3,0,4,4,3,4,2,20
ASV637,3,3,0,0,10,1,3,20
ASV1651,0,3,10,3,0,2,2,20
ASV1665,0,0,8,0,5,7,0,20
ASV1702,3,8,0,6,3,0,0,20
ASV2521,20,0,0,0,0,0,0,20
ASV2627,0,3,5,1,8,0,3,20
ASV2856,4,8,0,3,0,0,5,20
ASV2885,0,2,1,1,3,13,0,20
ASV3331,0,2,6,0,5,6,1,20
ASV3413,0,0,10,9,1,0,0,20
ASV3545,0,0,0,1,5,1,13,20
ASV3976,0,3,3,0,0,13,1,20
ASV4424,0,1,6,5,1,2,5,20
ASV4459,11,1,0,6,2,0,0,20
ASV4984,0,5,0,0,0,15,0,20
ASV5537,0,20,0,0,0,0,0,20
ASV6002,0,0,0,1,19,0,0,20
ASV6236,0,0,0,20,0,0,0,20
ASV6507,0,0,0,20,0,0,0,20
ASV6542,0,0,0,0,7,0,13,20
ASV6837,0,0,2,2,0,6,10,20
ASV6952,0,5,5,0,10,0,0,20
ASV7161,0,0,7,0,0,13,0,20
ASV7250,0,0,11,0,9,0,0,20
ASV7470,2,0,4,7,5,2,0,20
ASV7491,2,0,0,2,0,9,7,20
ASV7646,0,0,0,0,0,0,20,20
ASV7918,0,0,3,0,8,3,6,20
ASV8540,0,0,10,10,0,0,0,20
ASV8561,0,0,5,0,0,0,15,20
ASV8810,0,0,17,0,0,3,0,20
ASV8988,0,8,12,0,0,0,0,20
ASV9215,0,0,0,0,6,0,14,20
ASV9542,6,0,0,11,3,0,0,20
ASV9733,0,0,0,14,2,4,0,20
ASV10006,0,12,5,0,1,1,1,20
ASV10038,0,5,3,3,9,0,0,20
ASV10121,0,17,2,0,1,0,0,20
ASV10274,0,0,5,0,3,10,2,20
ASV10439,0,0,6,4,2,8,0,20
ASV10553,0,0,19,1,0,0,0,20
ASV10702,0,2,0,0,18,0,0,20
ASV11048,0,4,7,0,6,3,0,20
ASV11151,0,7,0,13,0,0,0,20
ASV11157,0,1,5,1,0,13,0,20
ASV11343,0,0,0,8,0,9,3,20
ASV12031,0,8,0,2,1,0,9,20
ASV12068,0,0,2,15,0,0,3,20
ASV12206,2,7,3,4,1,0,3,20
ASV12464,0,0,0,0,20,0,0,20
ASV12528,1,4,3,4,4,0,4,20
ASV12533,0,0,2,10,2,4,2,20
ASV12747,0,0,0,11,0,3,6,20
ASV13250,7,0,5,0,0,8,0,20
ASV13356,0,0,2,0,6,12,0,20
ASV13573,2,0,0,4,14,0,0,20
ASV13591,0,2,3,0,5,7,3,20
ASV13727,0,5,0,5,0,10,0,20
ASV13741,0,0,0,0,5,15,0,20
ASV13770,0,0,6,3,0,11,0,20
ASV13982,0,0,2,0,0,4,14,20
ASV14227,0,0,5,10,2,2,1,20
ASV14448,0,9,1,0,3,4,3,20
ASV14991,0,1,0,0,0,0,19,20
ASV15214,0,6,9,2,0,1,2,20
ASV15274,0,0,5,0,15,0,0,20
ASV15992,0,10,8,0,0,2,0,20
ASV16212,0,2,0,10,5,1,2,20
ASV16237,0,0,20,0,0,0,0,20
ASV16383,18,0,0,0,2,0,0,20
ASV16547,0,1,18,0,0,1,0,20
ASV17019,2,0,2,10,6,0,0,20
ASV17772,0,0,2,3,4,7,4,20
ASV17951,0,0,2,8,0,7,3,20
ASV18017,0,0,17,0,0,0,3,20
ASV18773,0,0,14,0,0,0,6,20
ASV18785,18,0,2,0,0,0,0,20
ASV18943,0,0,4,5,0,0,11,20
ASV19037,0,4,9,3,3,1,0,20
ASV19934,0,0,2,18,0,0,0,20
ASV20565,0,0,0,0,20,0,0,20
ASV20712,7,1,1,2,7,0,2,20
ASV20789,0,0,9,0,9,0,2,20
ASV21144,0,0,7,0,0,1,12,20
ASV21232,0,0,3,0,4,13,0,20
ASV21747,0,0,0,0,1,0,19,20
ASV22058,0,0,0,0,9,11,0,20
ASV23776,5,0,0,4,10,1,0,20
ASV24085,0,7,0,5,0,0,8,20
ASV24754,8,0,0,12,0,0,0,20
ASV25528,0,0,6,0,14,0,0,20
ASV25789,2,3,6,8,1,0,0,20
ASV26215,0,0,9,4,0,5,2,20
ASV568,7,6,3,0,3,0,0,19
ASV794,0,0,0,4,5,7,3,19
ASV890,0,1,15,0,0,3,0,19
ASV1223,0,0,0,2,6,6,5,19
ASV1955,0,2,0,0,12,2,3,19
ASV2236,12,0,1,3,0,3,0,19
ASV2290,0,0,7,3,1,5,3,19
ASV2365,0,5,2,5,4,0,3,19
ASV2920,1,0,0,4,0,4,10,19
ASV3074,0,4,4,0,6,0,5,19
ASV3327,0,0,0,6,12,0,1,19
ASV3554,0,2,10,1,1,5,0,19
ASV3598,0,0,0,4,5,0,10,19
ASV3735,0,0,0,0,19,0,0,19
ASV3876,0,0,17,0,2,0,0,19
ASV4011,0,2,0,13,0,0,4,19
ASV5159,0,0,1,5,7,3,3,19
ASV5632,0,1,0,4,4,0,10,19
ASV6042,0,10,6,3,0,0,0,19
ASV7049,0,1,13,0,5,0,0,19
ASV7065,0,3,2,0,6,8,0,19
ASV7361,0,0,10,0,9,0,0,19
ASV7518,0,0,11,4,4,0,0,19
ASV8010,0,4,0,0,15,0,0,19
ASV8134,0,2,4,10,1,0,2,19
ASV8226,0,0,16,0,0,0,3,19
ASV8655,0,0,19,0,0,0,0,19
ASV8877,0,0,4,0,0,10,5,19
ASV9190,0,0,0,19,0,0,0,19
ASV9310,0,0,0,0,19,0,0,19
ASV9738,0,0,0,15,0,0,4,19
ASV10022,0,19,0,0,0,0,0,19
ASV10136,0,0,10,0,0,5,4,19
ASV10781,11,0,1,0,0,4,3,19
ASV10806,0,8,2,0,0,3,6,19
ASV11432,0,2,0,10,7,0,0,19
ASV11548,3,0,1,4,6,0,5,19
ASV13145,2,0,2,0,3,6,6,19
ASV13223,0,2,0,7,6,0,4,19
ASV13328,0,4,0,1,7,0,7,19
ASV13539,2,0,1,0,5,0,11,19
ASV13823,0,0,8,3,8,0,0,19
ASV14810,4,4,5,2,0,0,4,19
ASV15018,0,0,5,2,0,0,12,19
ASV15029,3,0,16,0,0,0,0,19
ASV15086,0,0,0,12,1,0,6,19
ASV15234,0,0,0,5,8,0,6,19
ASV15245,0,0,0,17,0,0,2,19
ASV15299,0,0,1,7,0,7,4,19
ASV16366,0,0,0,0,2,0,17,19
ASV16432,0,0,2,14,0,3,0,19
ASV16788,0,1,3,5,0,5,5,19
ASV17284,8,4,3,3,0,1,0,19
ASV17954,0,0,0,0,3,16,0,19
ASV19208,0,0,9,0,0,8,2,19
ASV20929,5,0,5,1,0,2,6,19
ASV20968,0,0,4,0,6,0,9,19
ASV21638,5,0,0,8,0,0,6,19
ASV22141,13,0,0,0,5,1,0,19
ASV22445,0,1,10,5,3,0,0,19
ASV23689,0,2,2,8,3,0,4,19
ASV24788,0,0,0,0,19,0,0,19
ASV25247,0,0,0,0,0,0,19,19
ASV27121,0,0,0,0,14,0,5,19
ASV288,2,3,0,1,0,0,12,18
ASV554,0,1,2,0,0,15,0,18
ASV1107,0,0,4,1,9,4,0,18
ASV1111,3,5,7,0,0,3,0,18
ASV1226,0,0,2,7,3,0,6,18
ASV1587,0,0,3,12,0,0,3,18
ASV1905,4,8,1,0,0,5,0,18
ASV2027,0,0,0,0,1,3,14,18
ASV2109,0,0,3,3,2,0,10,18
ASV2711,0,0,0,18,0,0,0,18
ASV2783,0,5,0,1,11,0,1,18
ASV2973,0,0,2,0,16,0,0,18
ASV3843,0,0,0,0,0,0,18,18
ASV3874,0,0,4,1,6,0,7,18
ASV3975,0,0,0,18,0,0,0,18
ASV4079,0,0,3,4,5,4,2,18
ASV4087,0,0,8,1,0,7,2,18
ASV4272,3,0,9,2,1,2,1,18
ASV4902,0,0,0,18,0,0,0,18
ASV5327,0,0,15,2,1,0,0,18
ASV5366,0,1,4,4,5,0,4,18
ASV5733,0,0,0,0,0,0,18,18
ASV5786,0,0,12,2,1,3,0,18
ASV5898,0,2,3,0,4,6,3,18
ASV6057,0,0,8,0,0,0,10,18
ASV6092,1,0,0,0,12,0,5,18
ASV6484,0,10,4,4,0,0,0,18
ASV6533,0,0,1,0,0,9,8,18
ASV7198,0,1,0,2,12,0,3,18
ASV7735,0,0,9,0,0,0,9,18
ASV7853,0,0,3,0,15,0,0,18
ASV8053,0,3,10,0,0,5,0,18
ASV9109,0,0,0,0,0,18,0,18
ASV9361,7,5,0,0,6,0,0,18
ASV9452,0,11,0,4,0,0,3,18
ASV9491,0,0,0,3,0,14,1,18
ASV9919,0,5,13,0,0,0,0,18
ASV11095,0,6,0,5,1,5,1,18
ASV11409,0,4,0,0,10,0,4,18
ASV11482,0,0,0,0,0,18,0,18
ASV11711,0,0,11,0,0,7,0,18
ASV11814,9,0,3,6,0,0,0,18
ASV12589,0,0,3,8,3,2,2,18
ASV12744,0,0,0,0,0,0,18,18
ASV13213,0,0,16,0,0,2,0,18
ASV13257,0,0,6,0,0,11,1,18
ASV13615,2,0,2,0,3,10,1,18
ASV13843,0,0,2,1,6,1,8,18
ASV13929,3,0,0,0,3,3,9,18
ASV13943,0,2,0,9,2,0,5,18
ASV14035,0,0,0,0,0,0,18,18
ASV14204,0,2,2,9,0,3,2,18
ASV14354,0,3,12,3,0,0,0,18
ASV14903,0,18,0,0,0,0,0,18
ASV15716,0,0,6,0,9,0,3,18
ASV16196,0,0,18,0,0,0,0,18
ASV16510,0,0,18,0,0,0,0,18
ASV16776,0,0,0,0,0,0,18,18
ASV17011,0,0,0,13,0,0,5,18
ASV17244,0,1,12,0,0,5,0,18
ASV17932,0,0,0,9,0,0,9,18
ASV18302,0,0,0,18,0,0,0,18
ASV18618,0,0,6,2,0,6,4,18
ASV18815,0,0,0,18,0,0,0,18
ASV19031,0,1,0,0,1,0,16,18
ASV19186,0,0,0,4,13,0,1,18
ASV19725,0,0,0,0,0,0,18,18
ASV19743,4,3,7,2,0,1,1,18
ASV20728,0,18,0,0,0,0,0,18
ASV21065,0,0,0,18,0,0,0,18
ASV21212,0,0,1,0,3,0,14,18
ASV21445,0,0,7,4,0,4,3,18
ASV21488,0,18,0,0,0,0,0,18
ASV21882,0,7,10,1,0,0,0,18
ASV24867,0,18,0,0,0,0,0,18
ASV26654,0,0,0,15,0,0,3,18
ASV26789,0,0,5,0,0,8,5,18
ASV27145,0,4,9,5,0,0,0,18
ASV666,2,3,0,0,8,0,4,17
ASV898,0,0,9,0,0,8,0,17
ASV1348,3,0,0,1,0,0,13,17
ASV1388,0,0,0,0,4,4,9,17
ASV1389,0,4,7,0,4,2,0,17
ASV1409,0,0,4,1,11,1,0,17
ASV2770,1,0,12,0,2,0,2,17
ASV3130,0,0,4,1,0,0,12,17
ASV3145,0,3,12,2,0,0,0,17
ASV3293,0,0,10,0,0,0,7,17
ASV3888,1,0,8,2,6,0,0,17
ASV4071,14,3,0,0,0,0,0,17
ASV4265,0,0,0,0,1,15,1,17
ASV4371,0,4,0,2,7,0,4,17
ASV4416,0,8,0,1,0,0,8,17
ASV4477,0,3,0,6,8,0,0,17
ASV4938,0,7,7,1,0,0,2,17
ASV5754,0,0,0,0,2,5,10,17
ASV6061,0,0,2,1,0,13,1,17
ASV6071,0,0,3,4,2,0,8,17
ASV6196,0,0,2,7,8,0,0,17
ASV6212,0,0,3,6,0,6,2,17
ASV6226,0,4,0,1,2,6,4,17
ASV6666,0,0,0,7,2,8,0,17
ASV6733,0,0,1,11,0,5,0,17
ASV7279,1,4,0,0,0,9,3,17
ASV8220,0,1,5,0,9,0,2,17
ASV8297,0,0,0,0,4,7,6,17
ASV8351,1,0,0,10,1,5,0,17
ASV8666,0,1,3,5,0,3,5,17
ASV9032,0,7,0,0,4,0,6,17
ASV9412,0,2,3,0,12,0,0,17
ASV10542,0,0,0,4,9,0,4,17
ASV10692,0,0,0,0,5,8,4,17
ASV10901,0,2,0,0,0,0,15,17
ASV11220,0,0,0,0,0,0,17,17
ASV11266,0,0,17,0,0,0,0,17
ASV11459,0,3,9,2,0,3,0,17
ASV11819,0,0,4,1,5,5,2,17
ASV12422,0,0,0,0,13,0,4,17
ASV12779,0,0,0,17,0,0,0,17
ASV12821,0,0,0,1,0,1,15,17
ASV13094,8,0,0,2,1,3,3,17
ASV13488,0,12,0,0,0,5,0,17
ASV13746,0,3,0,0,7,0,7,17
ASV13999,0,0,2,0,15,0,0,17
ASV14840,2,3,0,0,10,2,0,17
ASV15212,0,4,6,0,7,0,0,17
ASV15240,0,0,0,0,0,0,17,17
ASV15419,0,0,0,0,0,6,11,17
ASV15531,0,3,0,0,4,0,10,17
ASV15978,0,0,3,14,0,0,0,17
ASV16419,6,0,6,0,5,0,0,17
ASV16802,0,4,2,11,0,0,0,17
ASV17180,0,0,0,0,2,0,15,17
ASV17367,0,1,13,0,0,3,0,17
ASV17572,0,7,4,0,0,6,0,17
ASV19960,0,6,0,11,0,0,0,17
ASV20336,0,0,5,3,2,0,7,17
ASV20939,5,9,0,0,3,0,0,17
ASV21091,0,1,1,0,12,0,3,17
ASV21352,0,9,7,0,0,1,0,17
ASV22014,0,0,6,1,0,10,0,17
ASV23574,0,0,17,0,0,0,0,17
ASV23609,0,0,15,0,0,2,0,17
ASV24079,0,0,0,0,17,0,0,17
ASV24491,0,0,0,0,0,17,0,17
ASV25105,0,0,0,0,0,1,16,17
ASV25267,0,3,8,6,0,0,0,17
ASV26521,0,0,2,0,0,0,15,17
ASV437,0,0,0,9,1,4,2,16
ASV654,0,0,16,0,0,0,0,16
ASV833,0,0,6,0,6,0,4,16
ASV942,0,0,0,0,7,5,4,16
ASV1638,0,0,0,9,7,0,0,16
ASV1878,1,6,9,0,0,0,0,16
ASV2322,15,1,0,0,0,0,0,16
ASV2883,0,0,13,0,0,0,3,16
ASV3009,0,5,0,1,0,0,10,16
ASV3714,0,0,0,0,16,0,0,16
ASV3985,14,0,0,0,2,0,0,16
ASV4013,0,1,7,0,1,7,0,16
ASV4036,0,5,5,4,2,0,0,16
ASV4038,0,4,1,5,6,0,0,16
ASV4157,2,0,1,3,0,0,10,16
ASV4297,0,0,6,0,1,9,0,16
ASV5616,3,2,3,4,0,4,0,16
ASV5674,0,0,14,2,0,0,0,16
ASV5765,3,4,0,6,0,2,1,16
ASV6109,0,0,16,0,0,0,0,16
ASV6401,0,0,6,8,0,2,0,16
ASV6464,6,0,1,0,0,7,2,16
ASV8019,1,15,0,0,0,0,0,16
ASV8248,0,4,9,2,0,0,1,16
ASV8551,0,0,2,7,7,0,0,16
ASV8675,0,0,0,1,0,10,5,16
ASV8913,0,0,0,4,11,1,0,16
ASV9053,0,0,0,0,0,5,11,16
ASV9597,0,0,3,7,0,0,6,16
ASV9832,0,0,5,4,6,1,0,16
ASV10396,0,0,5,0,0,4,7,16
ASV10749,0,0,0,0,5,0,11,16
ASV10955,0,0,16,0,0,0,0,16
ASV11629,0,1,11,0,4,0,0,16
ASV11775,0,5,2,1,0,0,8,16
ASV12425,0,0,9,0,0,3,4,16
ASV13743,0,4,0,10,2,0,0,16
ASV14877,0,5,0,0,3,4,4,16
ASV16404,0,0,9,0,0,7,0,16
ASV16437,0,0,1,9,5,0,1,16
ASV17429,0,0,1,3,7,0,5,16
ASV18128,0,0,4,4,0,0,8,16
ASV18684,0,0,3,5,0,4,4,16
ASV19245,0,0,0,0,10,0,6,16
ASV20491,0,0,0,0,16,0,0,16
ASV21893,0,0,0,0,0,16,0,16
ASV22078,0,0,9,0,0,0,7,16
ASV24769,0,0,0,10,6,0,0,16
ASV25852,0,5,0,0,11,0,0,16
ASV26220,0,2,3,0,0,11,0,16
ASV26791,15,1,0,0,0,0,0,16
ASV126,0,1,0,8,0,4,2,15
ASV1058,0,9,0,0,0,6,0,15
ASV1313,6,0,1,2,0,2,4,15
ASV3404,0,0,0,5,7,3,0,15
ASV3489,0,0,3,0,3,5,4,15
ASV4031,0,0,3,10,0,1,1,15
ASV5080,0,1,0,0,0,0,14,15
ASV5148,0,2,9,1,0,2,1,15
ASV5866,6,0,0,0,9,0,0,15
ASV6158,0,0,5,2,0,8,0,15
ASV6301,0,11,0,0,2,0,2,15
ASV8095,0,6,0,0,8,0,1,15
ASV8663,6,0,4,5,0,0,0,15
ASV10902,0,0,0,0,0,15,0,15
ASV11244,0,0,7,5,0,0,3,15
ASV15333,0,0,0,13,0,2,0,15
ASV15849,0,0,0,0,4,6,5,15
ASV17311,0,0,0,15,0,0,0,15
ASV21071,7,0,8,0,0,0,0,15
ASV23595,0,0,15,0,0,0,0,15
ASV24777,0,0,0,0,0,0,15,15
ASV25420,0,3,0,4,2,1,5,15
ASV25742,0,15,0,0,0,0,0,15
ASV26101,7,0,0,0,8,0,0,15
ASV26509,0,4,0,0,0,3,8,15
ASV526,0,0,0,0,10,4,0,14
ASV1375,0,0,0,6,0,2,6,14
ASV3197,0,0,12,1,0,1,0,14
ASV4541,0,0,0,0,9,5,0,14
ASV5197,0,0,0,0,3,3,8,14
ASV5939,0,4,3,0,0,0,7,14
ASV6765,0,0,0,0,0,0,14,14
ASV6821,0,1,9,0,0,0,4,14
ASV8787,0,2,3,7,0,2,0,14
ASV9156,0,0,2,0,11,0,1,14
ASV11856,0,4,5,0,5,0,0,14
ASV12252,0,0,0,5,0,9,0,14
ASV12893,12,0,0,2,0,0,0,14
ASV13888,0,3,3,2,0,0,6,14
ASV16028,0,0,6,0,7,1,0,14
ASV16654,0,0,0,11,0,0,3,14
ASV16721,10,0,0,4,0,0,0,14
ASV19598,0,0,4,0,2,2,6,14
ASV21994,0,0,4,10,0,0,0,14
ASV26870,0,1,0,0,10,3,0,14
ASV358,0,0,8,0,0,0,5,13
ASV1591,0,0,0,0,13,0,0,13
ASV1766,0,0,9,0,3,0,1,13
ASV1818,0,0,0,9,2,0,2,13
ASV1886,0,0,0,0,0,0,13,13
ASV2250,2,1,1,3,0,6,0,13
ASV3295,0,0,0,0,9,0,4,13
ASV4254,0,4,5,1,1,2,0,13
ASV4687,0,0,0,7,0,0,6,13
ASV5699,2,0,6,0,5,0,0,13
ASV6357,0,0,7,1,0,4,1,13
ASV7078,0,2,0,2,8,1,0,13
ASV7986,0,0,0,1,4,0,8,13
ASV8724,0,0,8,1,4,0,0,13
ASV8939,0,0,1,0,0,0,12,13
ASV9750,0,0,0,0,0,13,0,13
ASV12966,6,0,0,1,6,0,0,13
ASV13518,1,3,0,1,5,3,0,13
ASV16002,2,4,0,1,0,6,0,13
ASV17588,3,4,1,0,1,0,4,13
ASV18443,0,0,0,0,0,0,13,13
ASV19165,0,0,0,13,0,0,0,13
ASV23530,1,0,3,0,1,7,1,13
ASV25000,0,0,1,0,12,0,0,13
ASV25391,0,0,0,13,0,0,0,13
ASV3024,0,0,8,0,0,1,3,12
ASV3265,0,0,0,0,0,2,10,12
ASV3825,0,0,0,2,9,0,1,12
ASV4833,11,0,0,0,1,0,0,12
ASV5000,0,0,3,0,0,5,4,12
ASV6501,0,3,0,5,1,0,3,12
ASV8028,1,0,2,1,8,0,0,12
ASV10225,5,0,0,0,0,0,7,12
ASV12895,0,10,0,1,0,1,0,12
ASV18169,0,0,2,6,0,4,0,12
ASV19416,0,0,2,0,0,1,9,12
ASV26178,0,2,5,1,1,0,3,12
ASV906,0,0,3,0,0,6,2,11
ASV8381,3,6,0,0,0,0,2,11
ASV14450,0,2,0,7,2,0,0,11
ASV14754,0,0,11,0,0,0,0,11
ASV18301,3,0,7,0,0,0,1,11
ASV23050,0,0,0,0,0,7,4,11
ASV3932,2,2,0,1,4,0,1,10
ASV10145,4,1,2,0,0,0,3,10
ASV12143,0,0,0,0,0,2,8,10
ASV15404,3,0,0,0,3,2,2,10
ASV18272,0,0,0,2,8,0,0,10
ASV2714,0,1,0,1,0,2,5,9
ASV12427,0,0,0,0,7,0,2,9
ASV14473,0,8,0,0,0,0,1,9
ASV5848,4,0,0,0,1,0,2,7
